["教育程度", "type"]	["哪种类型是entity的毕业学校？"]
["workInstitutions", "provost"]	["谁是entity的工作机构的教务长？"]
["使用平臺", "label"]	["entity的发布平台的标签是什么？"]
["相關團體", "label"]	["entity的相关团体的标签是什么？"]
["constell", "family"]	["谁是entity所属于的星座的家人？","谁是entity所属于的星座的父亲？"]
["city", "leaderName"]	["谁是entity的所在城市的领导者？"]
["教育程度", "ethnicGroups"]	["entity的毕业学校属于哪个民族？"]
["演出", "occupation"]	["出演entity的演员从事的职业是什么？","出演entity的演员的工作是什么？"]
["代表作", "format"]	["entity的代表作品的格式是什么？"]
["民族", "group"]	["entity所属的民族属于哪个组？"]
["territory", "leaderName"]	["谁是entity覆盖的区域的领导者？"]
["音樂類型", "stylisticOrigins"]	["entity的音乐类型的风格起源是什么？"]
["subdivisionName", "sovereigntyType"]	["什么是entity的主权类型？"]
["city", "leaderTitle"]	["entity的所在城市在哪里作为leaderTitle？"]
["spouse", "governor"]	["谁是entity的配偶的现任州长？"]
["president", "governor"]	["谁是entity效力的总统的现任州长？"]
["nationalteam", "club"]	["哪个俱乐部属于entity？"]
["region", "p"]	["如何用汉语拼音拼写entity所在的行政区？","entity所在的行政区的中文拼音是什么？"]
["parent", "owner"]	["谁是entity的主公司的所有者？"]
["parent", "divisions"]	["哪个唱片公司的entity的主公司拥有？"]
["residence", "leaderName"]	["谁是entity的居住地的领导者？"]
["doctoralAdvisor", "knownFor"]	["什么是entity的博士生导师知道的？"]
["doctoralAdvisor", "religion"]	["entity的博士生导师的宗教是什么？"]
["genusAuthority", "knownFor"]	["什么是entity的属PRU（生物PRU（）的命名者知道的？"]
["genusAuthority", "title"]	["什么是entity的属PRU（生物PRU（）的命名者的名字？"]
["after", "predecessor"]	["谁是entity的的前身？"]
["語言", "script"]	["什么是entity使用的语言的盲文？"]
["publisher", "subsid"]	["entity的出版商子公司的名称是什么？"]
["platforms", "media"]	["什么是entity的发布平台的媒体？"]
["播放地區", "cities"]	["哪个列表按人口排列entity中的城市地区？"]
["starring", "children"]	["参演entity的演员孩子的名字是什么？"]
["producer", "label"]	["entity的制片人的标签是什么？"]
["genre", "instruments"]	["entity的类型使用什么工具？"]
["title", "format"]	["entity的标题的格式是什么？"]
["subdivisionName", "largestmetro"]	["entity最大的地铁在哪里？"]
["artist", "genre"]	["发布entity的艺人属于哪种类型？"]
["countryofbirth", "languages"]	["谁使用entity的祖国的区域语言？"]
["countryofbirth", "callingCode"]	["什么是entity的祖国中的调用代码？"]
["monarch", "issue"]	["谁是entity的父母？"]
["popplace", "timezone"]	["entity的主要分布区域属于哪个时区？"]
["popplace", "mammal"]	["entity的主要分布区域中濒临灭绝的哺乳动物是什么？"]
["countryofbirth", "leaderName"]	["谁是entity的祖国的领导者？"]
["company", "type"]	["哪种类型是entity的运营公司？"]
["company", "services"]	["什么包含在entity的运营公司的服务中？"]
["leader", "title"]	["什么是entity的领导人的名字？"]
["company", "logo"]	["entity的运营公司的标识是什么？"]
["时代", "eventEnd"]	["什么时候entity哪个时代解散了？"]
["相關團體", "currentMembers"]	["谁是entity的相关团体的现任乐队领队？"]
["party", "ideology"]	["什么是entity所属的党派的政治意识形态？"]
["title", "candidate"]	["谁是entity的标题的候选人？"]
["combatant", "house"]	["entity有什么样的立法机构？"]
["distributor", "founder"]	["谁是entity的发行商的创始人？","谁创立了entity的发行商？"]
["genusAuthority", "birthPlace"]	["entity的属PRU（生物PRU（）的命名者出生在哪里？"]
["nationalteam", "stadium"]	["entity在哪里训练？"]
["birthPlace", "establishedEvent"]	["什么时候entity的出生地创建既定事件？"]
["binomialAuthority", "almaMater"]	["entity的二项式命名法学名的从哪里毕业？"]
["region", "callingCode"]	["什么是entity所在的行政区中的调用代码？"]
["usedBy", "leaderTitle"]	["entity的使用者在哪里作为leaderTitle？"]
["wars", "commander"]	["我们应该称之为到entity的战争的指挥官？"]
["city", "postalCode"]	["什么是entity的所在城市的邮政编码？"]
["birthplace", "regionalLanguages"]	["哪种语言是entityO第一CLPM支登场的球队中的区域语言？"]
["place", "subdivisionName"]	["entity的地址的细分名称是什么？"]
["place", "timezone"]	["entity的地址属于哪个时区？"]
["starring", "relatives"]	["谁是参演entity的演员的亲戚？"]
["successor", "successor"]	["谁是entity的一CLPM代产品的继承人？"]
["birthPlace", "north"]	["哪个城市位于entity的出生地的北部？"]
["author", "children"]	["entity的原著作者孩子的名字是什么？"]
["location", "callingCode"]	["什么是entity的位置中的调用代码？"]
["city", "northeast"]	["位于entity的所在城市东北的地方是什么？"]
["演出", "placeOfBirth"]	["出演entity的演员出生在哪里？"]
["lyrics", "label"]	["entity的的标签是什么？"]
["place", "leaderName"]	["谁是entity的地址的领导者？"]
["place", "subdivisionType"]	["entity的地址的行政级别是什么？"]
["nationalteam", "location"]	["entity在哪里？"]
["aircraftType", "type"]	["哪种类型是entity涉及的飞机型号？"]
["programmingLanguage", "dialects"]	["entity的开发语言的方言是什么？"]
["birthPlace", "leaderName"]	["谁是entity的出生地的领导者？"]
["managerclubs", "stadium"]	["entity执教的俱乐部在哪里训练？"]
["subdivisionName", "label"]	["entity的标签是什么？"]
["genre", "stylisticOrigins"]	["entity的类型的风格起源是什么？"]
["region", "leaderParty"]	["什么是entity所在的行政区的领导方？"]
["president", "successor"]	["谁是entity效力的总统的继承人？"]
["artist", "associatedActs"]	["谁与发布entity的艺人相关联？"]
["precededBy", "starring"]	["谁主演entity的一CLPM部作品？"]
["followedBy", "starring"]	["谁主演entity的一CLPM部作品？"]
["starring", "before"]	["谁是参演entity的演员的上一任？"]
["countryofbirth", "lowerHouse"]	["什么是entity的祖国的下议院？"]
["countryofbirth", "leaderTitle"]	["entity的祖国在哪里作为leaderTitle？"]
["city", "legislature"]	["什么是entity的所在城市的立法机关？"]
["college", "affiliations"]	["entity所就读的大学隶属于什么机构？"]
["platforms", "logo"]	["entity的发布平台的标识是什么？"]
["influenced", "education"]	["受到entity影响的人毕业的地方？","受到entity影响的人从哪个学校毕业？"]
["location", "leaderName"]	["谁是entity的位置的领导者？"]
["plat", "media"]	["什么是entity的发布平台的媒体？"]
["managerclubs", "manager"]	["谁是entity执教的俱乐部的经理？"]
["almaMater", "athletics"]	["entity的母校属于哪个协会？"]
["nationality", "establishedEvent"]	["什么时候entity的国籍创建既定事件？"]
["commander", "mother"]	["谁是entity的将领的母亲？"]
["company", "industry"]	["entity的运营公司所属的产业类型是什么？"]
["almaMater", "president"]	["谁是entity的母校的总裁？"]
["college", "type"]	["哪种类型是entity所就读的大学？"]
["draftTeam", "coach"]	["谁是选秀选中entity的球队的现任经理？"]
["almaMater", "nickname"]	["entity的母校的昵称是什么？"]
["region", "timezone"]	["entity所在的行政区属于哪个时区？"]
["operatingSystem", "supportedPlatforms"]	["entity的操作系统支持哪些平台？"]
["distributor", "divisions"]	["哪个唱片公司的entity的发行商拥有？"]
["subdivisionName", "subdivisionName"]	["entity的细分名称是什么？"]
["subdivisionName", "governmentType"]	["entity政府类型是什么？"]
["subdivisionName", "southwest"]	["位于entity西南的是什么？"]
["subdivisionName", "northeast"]	["位于entity东北的地方是什么？"]
["leader", "birthPlace"]	["entity的领导人出生在哪里？"]
["publisher", "divisions"]	["哪个唱片公司的entity的出版商拥有？"]
["leader", "issue"]	["谁是entity的领导人的父母？"]
["president", "title"]	["什么是entity效力的总统的名字？"]
["president", "predecessor"]	["谁是entity效力的总统的前身？"]
["seat", "governingBody"]	["entity的行政中心的管理机构是什么？"]
["party", "predecessor"]	["谁是entity所属的党派的前身？"]
["developer", "keyPeople"]	["谁是entity的开发商的首席执行官？"]
["producer", "associatedActs"]	["谁与entity的制片人相关联？"]
["states", "sovereigntyType"]	["什么是使用entity的地区的主权类型？"]
["states", "regionalLanguages"]	["哪种语言是使用entity的地区中的区域语言？"]
["place", "leaderTitle"]	["entity的地址在哪里作为leaderTitle？"]
["headquarters", "leaderTitle"]	["entity的总部地址在哪里作为leaderTitle？"]
["plat", "sourceModel"]	["哪一个是entity的发布平台的源模型？"]
["manufacturer", "logo"]	["entity的生产商的标识是什么？"]
["primaryUser", "caption"]	["entity的主要用户的标识是什么？"]
["語言", "fam"]	["entity使用的语言属于哪种语言？"]
["country", "establishedEvent"]	["什么时候entity的创建既定事件？"]
["successor", "predecessor"]	["谁是entity的一CLPM代产品的前身？"]
["after", "mother"]	["谁是entity的的母亲？"]
["writer", "deathPlace"]	["entity的作者死在哪里？","entity的作者的死亡地点是什么？"]
["nationalteam", "asstManager"]	["谁是entity的前助理教练？"]
["country", "leaderName"]	["谁是entity的的领导者？"]
["subdivisionName", "leaderTitle"]	["entity在哪里作为leaderTitle？"]
["region", "leader"]	["谁是entity所在的行政区的领导者？"]
["seat", "subdivisionName"]	["entity的行政中心的细分名称是什么？"]
["platforms", "manufacturer"]	["什么是entity的发布平台的制造商？","谁制作了entity的发布平台？"]
["garrison", "establishedEvent"]	["什么时候entity驻守的区域创建既定事件？"]
["constituencyWestminster", "candidate"]	["谁是entity的选区的候选人？"]
["successor", "mother"]	["谁是entity的一CLPM代产品的母亲？"]
["youthclubs", "manager"]	["谁是entity所属青年俱乐部的经理？"]
["discoverySite", "mammal"]	["entity的发现地区中濒临灭绝的哺乳动物是什么？"]
["debutteam", "list1."]	["谁是第一个在entity的O第一CLPM支球队中添加内容的人？"]
["finalteam", "list2."]	["谁是1904年entity效力的最后一CLPM支球队最好的右手投手？"]
["company", "owner"]	["谁是entity的运营公司的所有者？"]
["ground", "establishedEvent"]	["什么时候entity的地址创建既定事件？"]
["discoverySite", "upperHouse"]	["什么是entity的发现地区的上议院？"]
["subdivisionName", "p"]	["如何用汉语拼音拼写entity？","entity的中文拼音是什么？"]
["place", "cities"]	["哪个列表按人口排列entity的地址中的城市地区？"]
["place", "southwest"]	["位于entity的地址西南的是什么？"]
["place", "grass"]	["什么样的草原产于entity的地址？"]
["workInstitution", "athletics"]	["entity的工作机构属于哪个协会？"]
["line", "owner"]	["谁是entity的地铁线的所有者？"]
["company", "predecessor"]	["谁是entity的运营公司的前身？"]
["states", "leaderName"]	["谁是使用entity的地区的领导者？"]
["subdivisionName", "tree"]	["什么树大部分种植在entity？"]
["langs", "ethnicGroups"]	["entity擅长的语言属于哪个民族？"]
["successor", "spouse"]	["谁是entity的一CLPM代产品的配偶？"]
["successor", "alongside"]	["谁像entity的一CLPM代产品一样出名？","谁与entity的一CLPM代产品同样出名？"]
["label", "founder"]	["谁是entity的标签的创始人？","谁创立了entity的标签？"]
["starring", "almaMater"]	["参演entity的演员从哪里毕业？"]
["country", "officialReligion"]	["哪一项是entity的第一修正案的宗教条款中规定的受宪法保护的权利？"]
["country", "callingCode"]	["什么是entity的中的调用代码？"]
["president", "primeminister"]	["谁是entity效力的总统的首相？"]
["title", "genre"]	["entity的标题属于哪种类型？"]
["archipelago", "ethnicGroups"]	["entity的属于哪个民族？"]
["successor", "almaMater"]	["entity的一CLPM代产品从哪里毕业？"]
["almaMater", "affiliations"]	["entity的母校隶属于什么机构？"]
["ground", "label"]	["entity的地址的标签是什么？"]
["ground", "timezone"]	["entity的地址属于哪个时区？"]
["predecessor", "successor"]	["谁是entity的前代产品的继承人？"]
["citizenship", "establishedEvent"]	["什么时候entity的公民身份创建既定事件？"]
["語言", "sign"]	["entity使用的语言使用什么样的语言？"]
["currentclub", "chairman"]	["谁是entity的主席？"]
["before", "before"]	["谁是entity的前任的上一任？"]
["predecessor", "placeOfBirth"]	["entity的前代产品出生在哪里？"]
["president", "spouse"]	["谁是entity效力的总统的配偶？"]
["successor", "title"]	["什么是entity的一CLPM代产品的名字？"]
["writer", "occupation"]	["entity的作者从事的职业是什么？","entity的作者的工作是什么？"]
["location", "leaderTitle"]	["entity的位置在哪里作为leaderTitle？"]
["location", "northwest"]	["哪个地方位于entity的位置的西北部？"]
["champion", "manager"]	["谁是entity的总冠军的经理？"]
["主演", "occupation"]	["entity的演员从事的职业是什么？","entity的演员的工作是什么？"]
["leader", "religion"]	["entity的领导人的宗教是什么？"]
["starring", "parents"]	["谁养育了参演entity的演员？","谁把参演entity的演员抚养长大？","谁是参演entity的演员的父母？"]
["subdivisionName", "seat"]	["发现entity的地方是什么？"]
["party", "youthWing"]	["entity所属的党派的青年翼是什么？"]
["issue", "spouse"]	["谁是entity的后裔的配偶？"]
["areas", "leaderTitle"]	["entity在哪里作为leaderTitle？"]
["spouse", "issue"]	["谁是entity的配偶的父母？"]
["before", "issue"]	["谁是entity的前任的父母？"]
["operatingSystem", "label"]	["entity的操作系统的标签是什么？"]
["genre", "otherTopics"]	["entity的类型属于哪种音乐？"]
["subdivisionName", "seatType"]	["entity的行政级别是什么？"]
["operator", "owner"]	["谁是entity的相关运营A方是的所有者？"]
["subdivisionName", "title"]	["什么是entity的名字？"]
["subdivisionName", "motto"]	["什么是entity的座右铭？"]
["nationality", "demonym"]	["我们称之为entity的国籍的人是谁？"]
["音樂類型", "otherTopics"]	["entity的音乐类型属于哪种音乐？"]
["before", "spouse"]	["谁是entity的前任的配偶？"]
["platform", "updatemodel"]	["entity的运行平台更新模型的名称是什么？"]
["successor", "birthPlace"]	["entity的一CLPM代产品出生在哪里？"]
["birthPlace", "food"]	["entity的出生地中食物的无生命徽章是什么？"]
["music", "occupation"]	["entity的配乐作者从事的职业是什么？","entity的配乐作者的工作是什么？"]
["successor", "candidate"]	["谁是entity的一CLPM代产品的候选人？"]
["producer", "spouse"]	["谁是entity的制片人的配偶？"]
["predecessor", "birthPlace"]	["entity的前代产品出生在哪里？"]
["poleTeam", "before"]	["谁是entity的优胜车队的上一任？"]
["influencedBy", "influenced"]	["谁影响了P对entity产生影响的编码语言？"]
["successor", "placeOfBirth"]	["entity的一CLPM代产品出生在哪里？"]
["languages", "script"]	["什么是entity使用的语言的盲文？"]
["starring", "label"]	["参演entity的演员的标签是什么？"]
["主唱", "before"]	["谁是entity的主唱的上一任？"]
["國家", "ethnicGroups"]	["entity所属的国家属于哪个民族？"]
["國家", "callingCode"]	["什么是entity所属的国家中的调用代码？"]
["binomialAuthority", "title"]	["什么是entity的二项式命名法学名的的名字？"]
["countryofbirth", "governmentType"]	["entity的祖国政府类型是什么？"]
["platforms", "updatemodel"]	["entity的发布平台更新模型的名称是什么？"]
["cityofbirth", "region"]	["entity的出生地属于哪个列表？","哪个列表包含entity的出生地？"]
["cityofbirth", "p"]	["如何用汉语拼音拼写entity的出生地？","entity的出生地的中文拼音是什么？"]
["currentclub", "gk"]	["谁是entity的守门员？"]
["states", "demonym"]	["我们称之为使用entity的地区的人是谁？"]
["capital", "subdivisionName"]	["entity的首都的细分名称是什么？"]
["capital", "subdivisionType"]	["entity的首都的行政级别是什么？"]
["capital", "timezone"]	["entity的首都属于哪个时区？"]
["currentclub", "manager"]	["谁是entity的经理？"]
["cityofbirth", "northwest"]	["哪个地方位于entity的出生地的西北部？"]
["cityofbirth", "leaderTitle"]	["entity的出生地在哪里作为leaderTitle？"]
["successor", "deputy"]	["谁是entity的一CLPM代产品的部长？"]
["popplace", "languages"]	["谁使用entity的主要分布区域的区域语言？"]
["popplace", "leaderName"]	["谁是entity的主要分布区域的领导者？"]
["successor", "honorificPrefix"]	["entity的一CLPM代产品的荣誉称号是什么？"]
["predecessor", "title"]	["什么是entity的前代产品的名字？"]
["successor", "religion"]	["entity的一CLPM代产品的宗教是什么？"]
["commonLanguages", "script"]	["什么是entity的通用语言的盲文？"]
["almaMater", "logo"]	["entity的母校的标识是什么？"]
["distributor", "keyPeople"]	["谁是entity的发行商的首席执行官？"]
["nationalteam", "regionalName"]	["entity的地区名称是什么？"]
["areas", "highestpoint"]	["entity的最高点是什么？"]
["nationalteam", "title"]	["什么是entity的名字？"]
["associatedActs", "currentMembers"]	["谁是entity的相关艺人的现任乐队领队？"]
["教育程度", "affiliations"]	["entity的毕业学校隶属于什么机构？"]
["cityofbirth", "subdivisionName"]	["entity的出生地的细分名称是什么？"]
["countryofbirth", "ethnicGroups"]	["entity的祖国属于哪个民族？"]
["managerclubs", "owner"]	["谁是entity执教的俱乐部的所有者？"]
["cityofbirth", "leaderName"]	["谁是entity的出生地的领导者？"]
["doctoralStudents", "knownFor"]	["什么是entity的博士生知道的？"]
["series", "developer"]	["谁开发entity？","谁是entity的开发者？"]
["tenants", "stadium"]	["entity的承租方在哪里训练？"]
["stadium", "north"]	["哪个城市位于举办entity的体育场的北部？"]
["instrument", "caption"]	["entity使用的乐器的标识是什么？"]
["director", "occupation"]	["entity的导演从事的职业是什么？","entity的导演的工作是什么？"]
["location", "establishedTitle"]	["哪个法律","行为使entity的位置成立？"]
["origin", "establishedTitle"]	["哪个法律","行为使entity的发源地成立？"]
["origin", "leaderName"]	["谁是entity的发源地的领导者？"]
["連載雜誌", "genre"]	["连载entity的杂志属于哪种类型？"]
["author", "influences"]	["谁影响entity的原著作者？"]
["所屬公司", "owner"]	["谁是AentityEV的所属公司的所有者？"]
["states", "p"]	["如何用汉语拼音拼写使用entity的地区？","使用entity的地区的中文拼音是什么？"]
["artist", "occupation"]	["发布entity的艺人从事的职业是什么？","发布entity的艺人的工作是什么？"]
["city", "northwest"]	["哪个地方位于entity的所在城市的西北部？"]
["associatedActs", "associatedActs"]	["谁与entity的相关艺人相关联？"]
["fromAlbum", "genre"]	["entity的一CLPM部专辑属于哪种类型？"]
["referee", "leaderName"]	["谁是entity的裁判员的领导者？"]
["referee", "ethnicGroups"]	["entity的裁判员属于哪个民族？"]
["referee", "upperHouse"]	["什么是entity的裁判员的上议院？"]
["referee", "establishedEvent"]	["什么时候entity的裁判员创建既定事件？"]
["music", "associatedActs"]	["谁与entity的配乐作者相关联？"]
["subdivisionName", "leaderName"]	["谁是entity的领导者？"]
["country", "religion"]	["entity的的宗教是什么？"]
["founder", "successor"]	["谁是entity的创始人的继承人？"]
["founder", "spouse"]	["谁是entity的创始人的配偶？"]
["operatingSystem", "updatemodel"]	["entity的操作系统更新模型的名称是什么？"]
["countryofbirth", "regionalLanguages"]	["哪种语言是entity的祖国中的区域语言？"]
["stadium", "tenants"]	["哪个俱乐部举办entity的体育场租给哪个？","哪个俱乐部做租客举办entity的体育场？"]
["deathplace", "leaderName"]	["谁是entity逝世的地方的领导者？"]
["primeminister", "predecessor"]	["谁是entity的首相的前身？"]
["youthclubs", "title"]	["什么是entity所属青年俱乐部的名字？"]
["countryofbirth", "establishedEvent"]	["什么时候entity的祖国创建既定事件？"]
["起點站", "operator"]	["哪个公司entity的起点站属于？"]
["state", "deputy"]	["谁是entity所在的州的部长？"]
["countryofbirth", "sovereigntyType"]	["什么是entity的祖国的主权类型？"]
["genre", "derivatives"]	["什么是entity的类型的衍生物？"]
["youthclubs", "affiliations"]	["entity所属青年俱乐部隶属于什么机构？"]
["nationalteam", "rcb"]	["谁是entity最强的玩家？"]
["cityofbirth", "timezone"]	["entity的出生地属于哪个时区？"]
["youthclubs", "athletics"]	["entity所属青年俱乐部属于哪个协会？"]
["currentclub", "stadium"]	["entity在哪里训练？"]
["countryofbirth", "title"]	["什么是entity的祖国的名字？"]
["countryofbirth", "label"]	["entity的祖国的标签是什么？"]
["president", "children"]	["entity效力的总统孩子的名字是什么？"]
["countryofbirth", "seat"]	["发现entity的祖国的地方是什么？"]
["subdivisionName", "callingCode"]	["什么是entity中的调用代码？"]
["cityofbirth", "subdivisionType"]	["entity的出生地的行政级别是什么？"]
["manufacturer", "founder"]	["谁是entity的生产商的创始人？","谁创立了entity的生产商？"]
["manufacturer", "industry"]	["entity的生产商所属的产业类型是什么？"]
["after", "title"]	["什么是entity的的名字？"]
["stadium", "languages"]	["谁使用举办entity的体育场的区域语言？"]
["主演", "title"]	["什么是entity的演员的名字？"]
["producer", "genre"]	["entity的制片人属于哪种类型？"]
["deathPlace", "callingCode"]	["什么是entity逝世的地方中的调用代码？"]
["placeOfBirth", "leaderTitle"]	["entity的出生地在哪里作为leaderTitle？"]
["prev", "children"]	["entity的孩子的名字是什么？"]
["nominee", "children"]	["entity的提名人孩子的名字是什么？"]
["beforeElection", "successor"]	["谁是entity一CLPM任领导人的继承人？"]
["cityofbirth", "postalCode"]	["什么是entity的出生地的邮政编码？"]
["所屬公司", "logo"]	["AentityEV的所属公司的标识是什么？"]
["cities", "region"]	["entity属于哪个列表？","哪个列表包含entity？"]
["influencedBy", "logo"]	["P对entity产生影响的编码语言的标识是什么？"]
["lastAlbum", "starring"]	["谁主演entity的一CLPM张专辑？"]
["youthclubs", "chairman"]	["谁是entity所属青年俱乐部的主席？"]
["nationalteam", "referee"]	["谁是entity的裁判？"]
["currentclub", "ground"]	["entity的主场在哪里？"]
["location", "establishedEvent"]	["什么时候entity的位置创建既定事件？"]
["location", "upperHouse"]	["什么是entity的位置的上议院？"]
["stadium", "owner"]	["谁是举办entity的体育场的所有者？"]
["stadium", "referee"]	["谁是举办entity的体育场的裁判？"]
["stadium", "leaderTitle"]	["举办entity的体育场在哪里作为leaderTitle？"]
["managerclubs", "ground"]	["entity执教的俱乐部的主场在哪里？"]
["nextSeason", "title"]	["什么是entity的下一季的名字？"]
["nextSeason", "writtenby"]	["谁写过entity的下一季？","谁是entity的下一季的作者？"]
["doctoralAdvisor", "ancestry"]	["entity的博士生导师的家人来自哪里？","entity的博士生导师的故乡是什么？"]
["nationality", "label"]	["entity的国籍的标签是什么？"]
["label", "lcm"]	["谁是entity的标签的新QPR英雄？"]
["音樂類型", "instruments"]	["entity的音乐类型使用什么工具？"]
["stylisticOrigins", "derivatives"]	["什么是entity的风格源头的衍生物？"]
["music", "origin"]	["entity的配乐作者的起源是什么？"]
["usedBy", "lowerHouse"]	["什么是entity的使用者的下议院？"]
["followedBy", "directedby"]	["谁导演entity的一CLPM部作品？","谁是entity的一CLPM部作品的导演？"]
["manufacturer", "divisions"]	["哪个唱片公司的entity的生产商拥有？"]
["founder", "almaMater"]	["entity的创始人从哪里毕业？"]
["owner", "governmentType"]	["entity的总裁政府类型是什么？"]
["owner", "deputy"]	["谁是entity的总裁的部长？"]
["predecessor", "spouse"]	["谁是entity的前代产品的配偶？"]
["cityofbirth", "governingBody"]	["entity的出生地的管理机构是什么？"]
["commander", "placeOfDeath"]	["entity的将领死在哪里？","这是entity的将领的死亡地点？"]
["influencedBy", "dialects"]	["P对entity产生影响的编码语言的方言是什么？"]
["starring", "occupation"]	["参演entity的演员从事的职业是什么？","参演entity的演员的工作是什么？"]
["nextAlbum", "birthPlace"]	["entityLC之后的一CLPM部专辑出生在哪里？"]
["commonLanguages", "fam"]	["entity的通用语言属于哪种语言？"]
["cityofbirth", "areaCodeType"]	["entity的出生地有哪些类型的区号？"]
["commander", "birthPlace"]	["entity的将领出生在哪里？"]
["相關團體", "birthPlace"]	["entity的相关团体出生在哪里？"]
["locationCity", "seat"]	["发现entity的所在地的地方是什么？"]
["langs", "fam"]	["entity擅长的语言属于哪种语言？"]
["producer", "placeOfBirth"]	["entity的制片人出生在哪里？"]
["areas", "governor"]	["谁是entity的现任州长？"]
["leader", "deputy"]	["谁是entity的领导人的部长？"]
["母校", "type"]	["哪种类型是entity的母校？"]
["city", "p"]	["如何用汉语拼音拼写entity的所在城市？","entity的所在城市的中文拼音是什么？"]
["origin", "timezone"]	["entity的发源地属于哪个时区？"]
["製作", "keyPeople"]	["谁是entity的制作方的首席执行官？"]
["subdivisionName", "upperHouse"]	["什么是entity的上议院？"]
["platform", "logo"]	["entity的运行平台的标识是什么？"]
["教育程度", "mascot"]	["什么是entity的毕业学校的吉祥物？"]
["地址", "governmentType"]	["entity的地址政府类型是什么？"]
["subdivisionName", "type"]	["哪种类型是entity？"]
["music", "label"]	["entity的配乐作者的标签是什么？"]
["place", "p"]	["如何用汉语拼音拼写entity的地址？","entity的地址的中文拼音是什么？"]
["combatant", "event"]	["哪个文件","事件影响了entity的灭绝并在欧洲结束了第二次世界大战？"]
["poleTeam", "principal"]	["谁是entity的优胜车队的负责人？"]
["city", "location"]	["entity的所在城市在哪里？"]
["owner", "list3."]	["entity的总裁为之奋斗的第三支职业球队是什么？"]
["artist", "executiveProducer"]	["谁是发布entity的艺人的执行制片人？"]
["states", "lowerHouse"]	["什么是使用entity的地区的下议院？"]
["states", "ethnicGroups"]	["使用entity的地区属于哪个民族？"]
["states", "callingCode"]	["什么是使用entity的地区中的调用代码？"]
["nationalteam", "homeStadium"]	["什么是entity的主场？"]
["subdivisionName", "postalCodeType"]	["entity使用什么类型的邮政编码？"]
["langs", "ancestor"]	["entity擅长的语言的祖先在哪里？"]
["langs", "script"]	["什么是entity擅长的语言的盲文？"]
["line", "operator"]	["哪个公司entity的地铁线属于？"]
["country", "regionalLanguages"]	["哪种语言是entity的中的区域语言？"]
["areaServed", "callingCode"]	["什么是entity的服务区域中的调用代码？"]
["city", "demonym"]	["我们称之为entity的所在城市的人是谁？"]
["successor", "issue"]	["谁是entity的一CLPM代产品的父母？"]
["starring", "influences"]	["谁影响参演entity的演员？"]
["commonLanguages", "ancestor"]	["entity的通用语言的祖先在哪里？"]
["連載雜誌", "title"]	["什么是连载entity的杂志的名字？"]
["issue", "birthPlace"]	["entity的后裔出生在哪里？"]
["afterElection", "children"]	["entity的胜选者孩子的名字是什么？"]
["籍貫", "settlementType"]	["entity的籍贯属于哪个地区？"]
["territory", "postalCodeType"]	["entity覆盖的区域使用什么类型的邮政编码？"]
["place", "largestmetro"]	["entity的地址最大的地铁在哪里？"]
["territory", "areaCodeType"]	["entity覆盖的区域有哪些类型的区号？"]
["currentMembers", "associatedActs"]	["谁与entity的现任成员相关联？"]
["subdivisionName", "timezone"]	["entity属于哪个时区？"]
["platforms", "supportedPlatforms"]	["entity的发布平台支持哪些平台？"]
["basinCountries", "establishedEvent"]	["什么时候entity的沿线国家创建既定事件？"]
["territory", "seatType"]	["entity覆盖的区域的行政级别是什么？"]
["music", "birthPlace"]	["entity的配乐作者出生在哪里？"]
["政权", "leader"]	["谁是entity的的领导者？"]
["developer", "location"]	["entity的开发商在哪里？"]
["相關團體", "associatedActs"]	["谁与entity的相关团体相关联？"]
["lastAlbum", "producer"]	["谁是entity的一CLPM张专辑的制片人？"]
["city", "subdivisionName"]	["entity的所在城市的细分名称是什么？"]
["自治體", "mayor"]	["谁是entity的地方政府的市长？"]
["birthPlace", "southwest"]	["位于entity的出生地西南的是什么？"]
["predecessor", "alongside"]	["谁像entity的前代产品一样出名？","谁与entity的前代产品同样出名？"]
["fam", "fam"]	["entity的属于哪种语言？"]
["nationalteam", "coach"]	["谁是entity的现任经理？"]
["discoverySite", "subdivisionType"]	["entity的发现地区的行政级别是什么？"]
["residence", "leaderTitle"]	["entity的居住地在哪里作为leaderTitle？"]
["nationalteam", "round"]	["什么是entity的主场？","哪一个是entity的主场？"]
["所在地區", "leaderName"]	["谁是entity的所属区域的领导者？"]
["location", "ethnicGroups"]	["entity的位置属于哪个民族？"]
["location", "subdivisionType"]	["entity的位置的行政级别是什么？"]
["title", "list1."]	["谁是第一个在entity的标题中添加内容的人？"]
["youthclubs", "referee"]	["谁是entity所属青年俱乐部的裁判？"]
["predecessor", "predecessor"]	["谁是entity的前代产品的前身？"]
["starring", "title"]	["什么是参演entity的演员的名字？"]
["birthPlace", "subdivisionName"]	["entity的出生地的细分名称是什么？"]
["mother", "callingCode"]	["什么是entity的母亲中的调用代码？"]
["place", "deputy"]	["谁是entity的地址的部长？"]
["city", "region"]	["entity的所在城市属于哪个列表？","哪个列表包含entity的所在城市？"]
["location", "p"]	["如何用汉语拼音拼写entity的位置？","entity的位置的中文拼音是什么？"]
["currentclub", "nickname"]	["entity的昵称是什么？"]
["issue", "succession"]	["谁是entity的后裔的继承人？"]
["issue", "issue"]	["谁是entity的后裔的父母？"]
["developer", "industry"]	["entity的开发商所属的产业类型是什么？"]
["artist", "label"]	["发布entity的艺人的标签是什么？"]
["nextAlbum", "label"]	["entityLC之后的一CLPM部专辑的标签是什么？"]
["region", "demonym"]	["我们称之为entity所在的行政区的人是谁？"]
["label", "location"]	["entity的标签在哪里？"]
["city", "subdivisionType"]	["entity的所在城市的行政级别是什么？"]
["programmingLanguage", "influencedBy"]	["谁影响entity的开发语言？"]
["finalteam", "list1."]	["谁是第一个在entity效力的最后一CLPM支球队中添加内容的人？"]
["subdivisionName", "isoCode"]	["什么是entity的ISO代码？"]
["writer", "genre"]	["entity的作者属于哪种类型？"]
["starring", "birthPlace"]	["参演entity的演员出生在哪里？"]
["fromAlbum", "title"]	["什么是entity的一CLPM部专辑的名字？"]
["primeminister", "title"]	["什么是entity的首相的名字？"]
["nextAlbum", "title"]	["什么是entityLC之后的一CLPM部专辑的名字？"]
["lastAlbum", "genre"]	["entity的一CLPM张专辑属于哪种类型？"]
["county", "seatType"]	["entity所属的省份的行政级别是什么？"]
["combatant", "capital"]	["entity的首都在哪里？"]
["predecessor", "issue"]	["谁是entity的前代产品的父母？"]
["predecessor", "lowerHouse"]	["什么是entity的前代产品的下议院？"]
["經紀公司", "genre"]	["entity的经济公司属于哪种类型？"]
["monarch", "spouse"]	["谁是entity的配偶？"]
["出生地點", "callingCode"]	["什么是entity的出生地点中的调用代码？"]
["locationCountry", "ethnicGroups"]	["entity所在的国家属于哪个民族？"]
["lyrics", "notableInstruments"]	["哪种乐器entity的发挥并因此而闻名？"]
["country", "ethnicGroups"]	["entity的属于哪个民族？"]
["channel", "iptvServ"]	["entity的电视台推广什么样的IPTV服务？"]
["manufacturer", "keyPeople"]	["谁是entity的生产商的首席执行官？"]
["birthplace", "timezone"]	["entityO第一CLPM支登场的球队属于哪个时区？"]
["cityofbirth", "postalCodeType"]	["entity的出生地使用什么类型的邮政编码？"]
["所在地區", "southeast"]	["哪个城市位于entity的所属区域的东南部？"]
["birthplace", "religion"]	["entityO第一CLPM支登场的球队的宗教是什么？"]
["country", "upperHouse"]	["什么是entity的的上议院？"]
["developer", "subsid"]	["entity的开发商子公司的名称是什么？"]
["state", "timezone"]	["entity所在的州属于哪个时区？"]
["predecessor", "primeminister"]	["谁是entity的前代产品的首相？"]
["before", "birthPlace"]	["entity的前任出生在哪里？"]
["after", "primeminister"]	["谁是entity的的首相？"]
["country", "caption"]	["entity的的标识是什么？"]
["issue", "successor"]	["谁是entity的后裔的继承人？"]
["parent", "founder"]	["谁是entity的主公司的创始人？","谁创立了entity的主公司？"]
["debutteam", "manager"]	["谁是entity的O第一CLPM支球队的经理？"]
["subdivisionName", "highestpoint"]	["entity的最高点是什么？"]
["district", "leaderName"]	["谁是entity所在的区域的领导者？"]
["製作", "cableServ"]	["哪个公司entity的制作方属于？"]
["city", "mayor"]	["谁是entity的所在城市的市长？"]
["operatingSystem", "logo"]	["entity的操作系统的标识是什么？"]
["父親", "title"]	["什么是entity的父亲的名字？"]
["associatedActs", "label"]	["entity的相关艺人的标签是什么？"]
["演出", "birthPlace"]	["出演entity的演员出生在哪里？"]
["party", "founder"]	["谁是entity所属的党派的创始人？","谁创立了entity所属的党派？"]
["title", "capital"]	["entity的标题的首都在哪里？"]
["operator", "industry"]	["entity的相关运营A方是所属的产业类型是什么？"]
["workInstitution", "subsid"]	["entity的工作机构子公司的名称是什么？"]
["almaMater", "caption"]	["entity的母校的标识是什么？"]
["artist", "influences"]	["谁影响发布entity的艺人？"]
["children", "children"]	["entity的子女孩子的名字是什么？"]
["location", "bird"]	["哪种鸟类生物居住在entity的位置？"]
["areas", "establishedEvent"]	["什么时候entity创建既定事件？"]
["vicepresident", "successor"]	["谁是entity的副总统的继承人？"]
["workInstitution", "affiliations"]	["entity的工作机构隶属于什么机构？"]
["predecessor", "deputy"]	["谁是entity的前代产品的部长？"]
["唱片公司", "founder"]	["谁是entity与entity哪家唱片公司的创始人？","谁创立了entity与entity哪家唱片公司？"]
["state", "leaderParty"]	["什么是entity所在的州的领导方？"]
["lastAlbum", "writer"]	["谁写过entity的一CLPM张专辑？","谁是entity的一CLPM张专辑的作者？"]
["workplaces", "affiliations"]	["entity的工作地点隶属于什么机构？"]
["after", "before"]	["谁是entity的的上一任？"]
["commander", "predecessor"]	["谁是entity的将领的前身？"]
["starring", "spouse"]	["谁是参演entity的演员的配偶？"]
["leader", "alongside"]	["谁像entity的领导人一样出名？","谁与entity的领导人同样出名？"]
["city", "settlementType"]	["entity的所在城市属于哪个地区？"]
["city", "tree"]	["什么树大部分种植在entity的所在城市？"]
["followedBy", "genre"]	["entity的一CLPM部作品属于哪种类型？"]
["place", "label"]	["entity的地址的标签是什么？"]
["distributor", "location"]	["entity的发行商在哪里？"]
["county", "leaderName"]	["谁是entity所属的省份的领导者？"]
["distributor", "industry"]	["entity的发行商所属的产业类型是什么？"]
["commander", "deathPlace"]	["entity的将领死在哪里？","entity的将领的死亡地点是什么？"]
["combatant", "religion"]	["entity的宗教是什么？"]
["subdivisionName", "areaCodeType"]	["entity有哪些类型的区号？"]
["states", "upperHouse"]	["什么是使用entity的地区的上议院？"]
["states", "leaderTitle"]	["使用entity的地区在哪里作为leaderTitle？"]
["country", "currency"]	["entity的的货币是什么？"]
["nationalteam", "topScorer"]	["谁是entity的最佳射手？"]
["stadium", "seat"]	["发现举办entity的体育场的地方是什么？"]
["subdivisionName", "demonym"]	["我们称之为entity的人是谁？"]
["followedBy", "writer"]	["谁写过entity的一CLPM部作品？","谁是entity的一CLPM部作品的作者？"]
["province", "postalCodeType"]	["entity使用什么类型的邮政编码？"]
["publisher", "keyPeople"]	["谁是entity的出版商的首席执行官？"]
["capital", "establishedTitle"]	["哪个法律","行为使entity的首都成立？"]
["頻道", "language"]	["放映entity的频道的语言是什么？"]
["after", "birthPlace"]	["entity的出生在哪里？"]
["artist", "notableInstruments"]	["哪种乐器发布entity的艺人发挥并因此而闻名？"]
["subdivisionName", "soil"]	["entity的州土壤是什么？"]
["subdivisionName", "reptile"]	["什么是entity的官方国家爬行动物？"]
["youthclubs", "gk"]	["谁是entity所属青年俱乐部的守门员？"]
["title", "family"]	["谁是entity的标题的家人？","谁是entity的标题的父亲？"]
["before", "title"]	["什么是entity的前任的名字？"]
["countryofbirth", "upperHouse"]	["什么是entity的祖国的上议院？"]
["subdivisionName", "translitLang1Type"]	["什么是entity的翻译方案？"]
["出生地", "region"]	["entity的出生地属于哪个列表？","哪个列表包含entity的出生地？"]
["subdivisionName", "legislature"]	["什么是entity的立法机关？"]
["popplace", "establishedEvent"]	["什么时候entity的主要分布区域创建既定事件？"]
["popplace", "upperHouse"]	["什么是entity的主要分布区域的上议院？"]
["代表作", "relatives"]	["谁是entity的代表作品的亲戚？"]
["headquarters", "leaderName"]	["谁是entity的总部地址的领导者？"]
["referee", "leaderTitle"]	["entity的裁判员在哪里作为leaderTitle？"]
["种族", "group"]	["entity的种族属于哪个组？"]
["birthplace", "leaderTitle"]	["entityO第一CLPM支登场的球队在哪里作为leaderTitle？"]
["usedBy", "establishedEvent"]	["什么时候entity的使用者创建既定事件？"]
["location", "label"]	["entity的位置的标签是什么？"]
["primeminister", "deputy"]	["谁是entity的首相的部长？"]
["territory", "p"]	["如何用汉语拼音拼写entity覆盖的区域？","entity覆盖的区域的中文拼音是什么？"]
["education", "type"]	["哪种类型是entity？"]
["branch", "deputy"]	["谁是entity的的部长？"]
["location", "regionalLanguages"]	["哪种语言是entity的位置中的区域语言？"]
["countryofbirth", "house"]	["entity的祖国有什么样的立法机构？"]
["predecessor", "almaMater"]	["entity的前代产品从哪里毕业？"]
["appointer", "title"]	["什么是entity的任命者的名字？"]
["appointer", "bishop"]	["谁是entity的任命者的主教？"]
["predecessor", "honorificPrefix"]	["entity的前代产品的荣誉称号是什么？"]
["after", "successor"]	["谁是entity的的继承人？"]
["predecessor", "office"]	["entity的前代产品的职务是什么？"]
["states", "establishedEvent"]	["什么时候使用entity的地区创建既定事件？"]
["place", "languages"]	["谁使用entity的地址的区域语言？"]
["place", "callingCode"]	["什么是entity的地址中的调用代码？"]
["party", "leader"]	["谁是entity所属的党派的领导者？"]
["artist", "before"]	["谁是发布entity的艺人的上一任？"]
["birthPlace", "languages"]	["谁使用entity的出生地的区域语言？"]
["draftTeam", "owner"]	["谁是选秀选中entity的球队的所有者？"]
["territory", "blank1NameSec"]	["entity覆盖的区域属于什么？"]
["label", "successor"]	["谁是entity的标签的继承人？"]
["label", "subsid"]	["entity的标签子公司的名称是什么？"]
["location", "lowerHouse"]	["什么是entity的位置的下议院？"]
["country", "label"]	["entity的的标签是什么？"]
["prevSeason", "directedby"]	["谁导演entity的？","谁是entity的的导演？"]
["artist", "children"]	["发布entity的艺人孩子的名字是什么？"]
["subdivisionName", "establishedEvent"]	["什么时候entity创建既定事件？"]
["artist", "placeOfBirth"]	["发布entity的艺人出生在哪里？"]
["居住地", "settlementType"]	["entity的居住地属于哪个地区？"]
["starring", "education"]	["参演entity的演员毕业的地方？","参演entity的演员从哪个学校毕业？"]
["deathPlace", "establishedEvent"]	["什么时候entity逝世的地方创建既定事件？"]
["location", "governmentType"]	["entity的位置政府类型是什么？"]
["音樂類型", "agency"]	["哪个机构entity的音乐类型属于哪个？"]
["capital", "p"]	["如何用汉语拼音拼写entity的首都？","entity的首都的中文拼音是什么？"]
["現任成員", "birthPlace"]	["entity的现任成员出生在哪里？"]
["subdivisionName", "ethnicGroups"]	["entity属于哪个民族？"]
["territory", "leaderTitle"]	["entity覆盖的区域在哪里作为leaderTitle？"]
["動畫製作", "founder"]	["谁是entity的动画的创始人？","谁创立了entity的动画？"]
["prevSeason", "title"]	["什么是entity的的名字？"]
["publisher", "logo"]	["entity的出版商的标识是什么？"]
["workInstitutions", "affiliations"]	["entity的工作机构隶属于什么机构？"]
["publisher", "industry"]	["entity的出版商所属的产业类型是什么？"]
["college", "president"]	["谁是entity所就读的大学的总裁？"]
["college", "athletics"]	["entity所就读的大学属于哪个协会？"]
["college", "almaMater"]	["entity所就读的大学从哪里毕业？"]
["draftTeam", "manager"]	["谁是选秀选中entity的球队的经理？"]
["birthPlace", "populationBlank1Title"]	["什么是entity的出生地？"]
["place", "settlementType"]	["entity的地址属于哪个地区？"]
["citizenship", "demonym"]	["我们称之为entity的公民身份的人是谁？"]
["place", "type"]	["哪种类型是entity的地址？"]
["state", "largestmetro"]	["entity所在的州最大的地铁在哪里？"]
["state", "bird"]	["哪种鸟类生物居住在entity所在的州？"]
["starring", "predecessor"]	["谁是参演entity的演员的前身？"]
["draftTeam", "president"]	["谁是选秀选中entity的球队的总裁？"]
["college", "mascot"]	["什么是entity所就读的大学的吉祥物？"]
["college", "nickname"]	["entity所就读的大学的昵称是什么？"]
["college", "affiliation"]	["谁隶属于entity所就读的大学？"]
["birthPlace", "tartan"]	["什么是entity的出生地的官方苏格兰格子呢模式？"]
["頻道", "owner"]	["谁是放映entity的频道的所有者？"]
["channel", "satServ"]	["什么是entity的电视台的母公司？"]
["birthPlace", "bird"]	["哪种鸟类生物居住在entity的出生地？"]
["college", "logo"]	["entity所就读的大学的标识是什么？"]
["deathPlace", "region"]	["entity逝世的地方属于哪个列表？","哪个列表包含entity逝世的地方？"]
["draftTeam", "affiliation"]	["谁隶属于选秀选中entity的球队？"]
["college", "chairman"]	["谁是entity所就读的大学的主席？"]
["birthPlace", "establishedTitle"]	["哪个法律","行为使entity的出生地成立？"]
["nextAlbum", "producer"]	["谁是entityLC之后的一CLPM部专辑的制片人？"]
["title", "title"]	["什么是entity的标题的名字？"]
["managerclubs", "nickname"]	["entity执教的俱乐部的昵称是什么？"]
["origin", "callingCode"]	["什么是entity的发源地中的调用代码？"]
["origin", "establishedEvent"]	["什么时候entity的发源地创建既定事件？"]
["birthPlace", "governmentType"]	["entity的出生地政府类型是什么？"]
["deathPlace", "highestpoint"]	["entity逝世的地方的最高点是什么？"]
["cup", "stadium"]	["entity获得的奖项在哪里训练？"]
["birthPlace", "highestpoint"]	["entity的出生地的最高点是什么？"]
["nationality", "callingCode"]	["什么是entity的国籍中的调用代码？"]
["college", "provost"]	["谁是entity所就读的大学的教务长？"]
["birthPlace", "largestmetro"]	["entity的出生地最大的地铁在哪里？"]
["location", "before"]	["谁是entity的位置的上一任？"]
["awards", "starring"]	["谁主演entity获得的奖项？"]
["deathPlace", "areaCodeType"]	["entity逝世的地方有哪些类型的区号？"]
["music", "genre"]	["entity的配乐作者属于哪种类型？"]
["父親", "spouse"]	["谁是entity的父亲的配偶？"]
["fam", "child"]	["什么属于entity的？"]
["身份", "currency"]	["entity所在的朝代的货币是什么？"]
["时代", "currency"]	["entity哪个时代的货币是什么？"]
["nationality", "leaderName"]	["谁是entity的国籍的领导者？"]
["president", "party"]	["entity效力的总统属于哪一方？"]
["before", "type"]	["哪种类型是entity的前任？"]
["commander", "title"]	["什么是entity的将领的名字？"]
["電視台", "cableServ"]	["哪个公司播放entity的电视台属于？"]
["deathPlace", "subdivisionType"]	["entity逝世的地方的行政级别是什么？"]
["birthPlace", "motto"]	["什么是entity的出生地的座右铭？"]
["writer", "origin"]	["entity的作者的起源是什么？"]
["nationality", "officialReligion"]	["哪一项是entity的国籍第一修正案的宗教条款中规定的受宪法保护的权利？"]
["primaryUser", "aircraftTransport"]	["什么是entity的主要用户的飞机运输？"]
["before", "party"]	["entity的前任属于哪一方？"]
["predecessor", "before"]	["谁是entity的前代产品的上一任？"]
["successor", "deathPlace"]	["entity的一CLPM代产品死在哪里？","entity的一CLPM代产品的死亡地点是什么？"]
["before", "office"]	["entity的前任的职务是什么？"]
["before", "predecessor"]	["谁是entity的前任的前身？"]
["successor", "before"]	["谁是entity的一CLPM代产品的上一任？"]
["location", "sovereigntyType"]	["什么是entity的位置的主权类型？"]
["channel", "sisterNames"]	["什么是entity的电视台的姐妹名字？"]
["location", "languages"]	["谁使用entity的位置的区域语言？"]
["almaMater", "type"]	["哪种类型是entity的母校？"]
["discoverySite", "region"]	["entity的发现地区属于哪个列表？","哪个列表包含entity的发现地区？"]
["territory", "timezone"]	["entity覆盖的区域属于哪个时区？"]
["使用平台", "predecessor"]	["谁是entity的使用平台的前身？"]
["before", "primeminister"]	["谁是entity的前任的首相？"]
["almaMater", "mascot"]	["什么是entity的母校的吉祥物？"]
["locationCountry", "establishedEvent"]	["什么时候entity所在的国家创建既定事件？"]
["album", "title"]	["什么是entity所属的音乐专辑的名字？"]
["country", "titleLeader"]	["entity的中领导者的头衔是什么？"]
["spouse", "parents"]	["谁养育了entity的配偶？","谁把entity的配偶抚养长大？","谁是entity的配偶的父母？"]
["lastAlbum", "title"]	["什么是entity的一CLPM张专辑的名字？"]
["artist", "influenced"]	["谁影响了发布entity的艺人？"]
["successor", "father"]	["谁是entity的一CLPM代产品的父亲？"]
["时代", "religion"]	["entity哪个时代的宗教是什么？"]
["successor", "office"]	["entity的一CLPM代产品的职务是什么？"]
["birthPlace", "tree"]	["什么树大部分种植在entity的出生地？"]
["母校", "chancellor"]	["谁是entity的母校的总理？"]
["birthPlace", "eventEnd"]	["什么时候entity的出生地解散了？"]
["residence", "postalCodeType"]	["entity的居住地使用什么类型的邮政编码？"]
["spouse", "spouse"]	["谁是entity的配偶的配偶？"]
["spouse", "title"]	["什么是entity的配偶的名字？"]
["所屬公司", "type"]	["哪种类型是AentityEV的所属公司？"]
["父親", "house"]	["entity的父亲有什么样的立法机构？"]
["所屬公司", "location"]	["AentityEV的所属公司在哪里？"]
["subdivisionName", "lieutenantGovernor"]	["谁是entity现任副州长？"]
["唱片公司", "genre"]	["entity与entity哪家唱片公司属于哪种类型？"]
["语言", "script"]	["什么是entity所使用的语言的盲文？"]
["starring", "genre"]	["参演entity的演员属于哪种类型？"]
["nextSeason", "starring"]	["谁主演entity的下一季？"]
["nationality", "regionalLanguages"]	["哪种语言是entity的国籍中的区域语言？"]
["locale", "leaderTitle"]	["entityEV的所属地点在哪里作为leaderTitle？"]
["venue", "title"]	["什么是entity的举办场地的名字？"]
["birthPlace", "label"]	["entity的出生地的标签是什么？"]
["parent", "subsid"]	["entity的主公司子公司的名称是什么？"]
["nominee", "predecessor"]	["谁是entity的提名人的前身？"]
["afterElection", "predecessor"]	["谁是entity的胜选者的前身？"]
["publisher", "location"]	["entity的出版商在哪里？"]
["主演", "before"]	["谁是entity的演员的上一任？"]
["developer", "founder"]	["谁是entity的开发商的创始人？","谁创立了entity的开发商？"]
["所屬路線", "operator"]	["哪个公司entity的所属线路属于？"]
["cityofbirth", "bird"]	["哪种鸟类生物居住在entity的出生地？"]
["managerclubs", "title"]	["什么是entity执教的俱乐部的名字？"]
["predecessor", "candidate"]	["谁是entity的前代产品的候选人？"]
["producer", "birthPlace"]	["entity的制片人出生在哪里？"]
["discoverySite", "leaderTitle"]	["entity的发现地区在哪里作为leaderTitle？"]
["states", "legislature"]	["什么是使用entity的地区的立法机关？"]
["territory", "governingBody"]	["entity覆盖的区域的管理机构是什么？"]
["nationality", "ethnicGroups"]	["entity的国籍属于哪个民族？"]
["state", "title"]	["什么是entity所在的州的名字？"]
["stadium", "architect"]	["谁是举办entity的体育场的建筑师？","谁建立了举办entity的体育场？"]
["artist", "currentMembers"]	["谁是发布entity的艺人的现任乐队领队？"]
["title", "writer"]	["谁写过entity的标题？","谁是entity的标题的作者？"]
["location", "settlementType"]	["entity的位置属于哪个地区？"]
["monarch", "title"]	["什么是entity的名字？"]
["leader", "successor"]	["谁是entity的领导人的继承人？"]
["beforeElection", "title"]	["什么是entity一CLPM任领导人的名字？"]
["afterElection", "office"]	["entity的胜选者的职务是什么？"]
["publisher", "founder"]	["谁是entity的出版商的创始人？","谁创立了entity的出版商？"]
["usedBy", "demonym"]	["我们称之为entity的使用者的人是谁？"]
["主持", "occupation"]	["entity的主持人从事的职业是什么？","entity的主持人的工作是什么？"]
["founder", "before"]	["谁是entity的创始人的上一任？"]
["stylisticOrigins", "stylisticOrigins"]	["entity的风格源头的风格起源是什么？"]
["influences", "influences"]	["谁影响entity的人？"]
["state", "lieutenantGovernor"]	["谁是entity所在的州现任副州长？"]
["location", "timezone"]	["entity的位置属于哪个时区？"]
["education", "athletics"]	["entity属于哪个协会？"]
["album", "genre"]	["entity所属的音乐专辑属于哪种类型？"]
["headquarters", "p"]	["如何用汉语拼音拼写entity的总部地址？","entity的总部地址的中文拼音是什么？"]
["beforeElection", "religion"]	["entity一CLPM任领导人的宗教是什么？"]
["state", "soil"]	["entity所在的州的州土壤是什么？"]
["經紀公司", "type"]	["哪种类型是entity的经济公司？"]
["location", "demonym"]	["我们称之为entity的位置的人是谁？"]
["deputy", "successor"]	["谁是entity的代理人的继承人？"]
["语言", "fam"]	["entity所使用的语言属于哪种语言？"]
["areas", "soil"]	["entity的州土壤是什么？"]
["現任成員", "genre"]	["entity的现任成员属于哪种类型？"]
["artist", "relatives"]	["谁是发布entity的艺人的亲戚？"]
["writer", "label"]	["entity的作者的标签是什么？"]
["appointer", "successor"]	["谁是entity的任命者的继承人？"]
["appointer", "predecessor"]	["谁是entity的任命者的前身？"]
["state", "food"]	["entity所在的州中食物的无生命徽章是什么？"]
["residence", "timezoneDst"]	["entity的居住地属于哪个时区？"]
["workplaces", "chancellor"]	["谁是entity的工作地点的总理？"]
["location", "legislature"]	["什么是entity的位置的立法机关？"]
["territory", "settlementType"]	["entity覆盖的区域属于哪个地区？"]
["studio", "subsid"]	["制作entity的工作室子公司的名称是什么？"]
["birthPlace", "callingCode"]	["什么是entity的出生地中的调用代码？"]
["mother", "issue"]	["谁是entity的母亲的父母？"]
["programmingLanguage", "influenced"]	["谁影响了entity的开发语言？"]
["territory", "establishedTitle"]	["哪个法律","行为使entity覆盖的区域成立？"]
["territory", "subdivisionType"]	["entity覆盖的区域的行政级别是什么？"]
["主要语言", "ancestor"]	["entity使用的主要语言的祖先在哪里？"]
["father", "mother"]	["谁是entity的父亲的母亲？"]
["managerclubs", "subdivisionType"]	["entity执教的俱乐部的行政级别是什么？"]
["唱片公司", "logo"]	["entity与entity哪家唱片公司的标识是什么？"]
["唱片公司", "owner"]	["谁是entity与entity哪家唱片公司的所有者？"]
["territory", "governmentType"]	["entity覆盖的区域政府类型是什么？"]
["platforms", "predecessor"]	["谁是entity的发布平台的前身？"]
["stadium", "before"]	["谁是举办entity的体育场的上一任？"]
["stadium", "title"]	["什么是举办entity的体育场的名字？"]
["stadium", "leaderName"]	["谁是举办entity的体育场的领导者？"]
["stadium", "postalCode"]	["什么是举办entity的体育场的邮政编码？"]
["author", "predecessor"]	["谁是entity的原著作者的前身？"]
["father", "issue"]	["谁是entity的父亲的父母？"]
["mother", "title"]	["什么是entity的母亲的名字？"]
["afterElection", "governor"]	["谁是entity的胜选者的现任州长？"]
["locale", "title"]	["什么是entityEV的所属地点的名字？"]
["beforeElection", "birthPlace"]	["entity一CLPM任领导人出生在哪里？"]
["origin", "amphibian"]	["什么是IUCN脆弱的物种？青蛙？在entity的发源地？"]
["influences", "influenced"]	["谁影响了entity的人？"]
["label", "genre"]	["entity的标签属于哪种类型？"]
["所屬路線", "type"]	["哪种类型是entity的所属线路？"]
["monarch", "placeOfBirth"]	["entity出生在哪里？"]
["教育程度", "nickname"]	["entity的毕业学校的昵称是什么？"]
["region", "highestpoint"]	["entity所在的行政区的最高点是什么？"]
["所在", "postalCodeType"]	["entity所在的城市使用什么类型的邮政编码？"]
["title", "producer"]	["谁是entity的标题的制片人？"]
["writer", "associatedActs"]	["谁与entity的作者相关联？"]
["身份", "establishedEvent"]	["什么时候entity所在的朝代创建既定事件？"]
["owner", "industry"]	["entity的总裁所属的产业类型是什么？"]
["owner", "keyPeople"]	["谁是entity的总裁的首席执行官？"]
["issue", "house"]	["entity的后裔有什么样的立法机构？"]
["subdivisionName", "regionalLanguages"]	["哪种语言是entity中的区域语言？"]
["stadium", "demonym"]	["我们称之为举办entity的体育场的人是谁？"]
["title", "wing"]	["女性的entity的标题翼是什么？"]
["founder", "placeOfDeath"]	["entity的创始人死在哪里？","这是entity的创始人的死亡地点？"]
["线路", "type"]	["哪种类型是entity所属于的线路？"]
["location", "event"]	["哪个文件","事件影响了entity的位置的灭绝并在欧洲结束了第二次世界大战？"]
["nationality", "officialLanguages"]	["entity的国籍的官方语言是什么？"]
["電視台", "owner"]	["谁是播放entity的电视台的所有者？"]
["cityofbirth", "governor"]	["谁是entity的出生地的现任州长？"]
["nextSeason", "directedby"]	["谁导演entity的下一季？","谁是entity的下一季的导演？"]
["thirdDriver", "title"]	["什么是entity的车手的名字？"]
["platform", "influencedBy"]	["谁影响entity的运行平台？"]
["nationality", "leaderTitle"]	["entity的国籍在哪里作为leaderTitle？"]
["birthPlace", "ethnicGroups"]	["entity的出生地属于哪个民族？"]
["territory", "isoCode"]	["什么是entity覆盖的区域的ISO代码？"]
["语言", "ancestor"]	["entity所使用的语言的祖先在哪里？"]
["所屬公司", "subsid"]	["AentityEV的所属公司子公司的名称是什么？"]
["動畫製作", "keyPeople"]	["谁是entity的动画的首席执行官？"]
["nationalteam", "president"]	["谁是entity的总裁？"]
["manufacturer", "successor"]	["谁是entity的生产商的继承人？"]
["followedBy", "author"]	["谁是entity的一CLPM部作品的作者？"]
["almaMater", "chancellor"]	["谁是entity的母校的总理？"]
["電視網", "satServ"]	["什么是播放entity的电视台的母公司？"]
["discoverySite", "countryHeading"]	["entity的发现地区最终得到了什么？"]
["discoverySite", "p"]	["如何用汉语拼音拼写entity的发现地区？","entity的发现地区的中文拼音是什么？"]
["discoverySite", "southeast"]	["哪个城市位于entity的发现地区的东南部？"]
["discoverySite", "northeast"]	["位于entity的发现地区东北的地方是什么？"]
["discoverySite", "northwest"]	["哪个地方位于entity的发现地区的西北部？"]
["discoverySite", "southwest"]	["位于entity的发现地区西南的是什么？"]
["discoverySite", "north"]	["哪个城市位于entity的发现地区的北部？"]
["discoverySite", "mayor"]	["谁是entity的发现地区的市长？"]
["discoverer", "president"]	["谁是entity的发现者的总裁？"]
["discoverySite", "demonym"]	["我们称之为entity的发现地区的人是谁？"]
["discoverer", "religion"]	["entity的发现者的宗教是什么？"]
["discoverer", "affiliations"]	["entity的发现者隶属于什么机构？"]
["discoverer", "type"]	["哪种类型是entity的发现者？"]
["discoverer", "birthPlace"]	["entity的发现者出生在哪里？"]
["locationCountry", "regionalLanguages"]	["哪种语言是entity所在的国家中的区域语言？"]
["starring", "knownFor"]	["什么是参演entity的演员知道的？"]
["discoverySite", "location"]	["entity的发现地区在哪里？"]
["discoverySite", "leader"]	["谁是entity的发现地区的领导者？"]
["discoverer", "occupation"]	["entity的发现者从事的职业是什么？","entity的发现者的工作是什么？"]
["discoverer", "placeOfBirth"]	["entity的发现者出生在哪里？"]
["主唱", "occupation"]	["entity的主唱从事的职业是什么？","entity的主唱的工作是什么？"]
["garrison", "p"]	["如何用汉语拼音拼写entity驻守的区域？","entity驻守的区域的中文拼音是什么？"]
["channel", "logo"]	["entity的电视台的标识是什么？"]
["almaMater", "subdivisionName"]	["entity的母校的细分名称是什么？"]
["birthPlace", "settlementType"]	["entity的出生地属于哪个地区？"]
["areaServed", "leaderName"]	["谁是entity的服务区域的领导者？"]
["areaServed", "languages"]	["谁使用entity的服务区域的区域语言？"]
["placeOfDeath", "largestmetro"]	["entity的逝世地址最大的地铁在哪里？"]
["distributor", "subsid"]	["entity的发行商子公司的名称是什么？"]
["studio", "predecessor"]	["谁是制作entity的工作室的前身？"]
["afterElection", "successor"]	["谁是entity的胜选者的继承人？"]
["producer", "occupation"]	["entity的制片人从事的职业是什么？","entity的制片人的工作是什么？"]
["knownFor", "influenced"]	["谁影响了entity的成名作？"]
["播放地區", "leaderTitle"]	["entity在哪里作为leaderTitle？"]
["producer", "origin"]	["entity的制片人的起源是什么？"]
["nextAlbum", "genre"]	["entityLC之后的一CLPM部专辑属于哪种类型？"]
["播放地區", "demonym"]	["我们称之为entity的人是谁？"]
["lastAlbum", "label"]	["entity的一CLPM张专辑的标签是什么？"]
["label", "predecessor"]	["谁是entity的标签的前身？"]
["popplace", "nickname"]	["entity的主要分布区域的昵称是什么？"]
["ground", "p"]	["如何用汉语拼音拼写entity的地址？","entity的地址的中文拼音是什么？"]
["ground", "governmentType"]	["entity的地址政府类型是什么？"]
["主要语言", "fam"]	["entity使用的主要语言属于哪种语言？"]
["主要语言", "script"]	["什么是entity使用的主要语言的盲文？"]
["主要语言", "sign"]	["entity使用的主要语言使用什么样的语言？"]
["連接道路", "road"]	["entity在哪里运作？"]
["writer", "notableInstruments"]	["哪种乐器entity的作者发挥并因此而闻名？"]
["locationCity", "leaderName"]	["谁是entity的所在地的领导者？"]
["origin", "upperHouse"]	["什么是entity的发源地的上议院？"]
["president", "placeOfBirth"]	["entity效力的总统出生在哪里？"]
["popplace", "bird"]	["哪种鸟类生物居住在entity的主要分布区域？"]
["producer", "notableInstruments"]	["哪种乐器entity的制片人发挥并因此而闻名？"]
["after", "children"]	["entity的孩子的名字是什么？"]
["series", "successor"]	["谁是entity的继承人？"]
["母校", "nickname"]	["entity的母校的昵称是什么？"]
["binomialAuthority", "notableStudents"]	["谁是entity的二项式命名法学名的最着名的学生？"]
["garrison", "postalCodeType"]	["entity驻守的区域使用什么类型的邮政编码？"]
["stadium", "p"]	["如何用汉语拼音拼写举办entity的体育场？","举办entity的体育场的中文拼音是什么？"]
["教育程度", "athletics"]	["entity的毕业学校属于哪个协会？"]
["manufacturer", "type"]	["哪种类型是entity的生产商？"]
["民族", "caption"]	["entity所属的民族的标识是什么？"]
["ground", "leaderParty"]	["什么是entity的地址的领导方？"]
["leaderParty", "youthWing"]	["entity的的青年翼是什么？"]
["nationality", "religion"]	["entity的国籍的宗教是什么？"]
["使用平臺", "media"]	["什么是entity的发布平台的媒体？"]
["director", "education"]	["entity的导演毕业的地方？","entity的导演从哪个学校毕业？"]
["教育程度", "logo"]	["entity的毕业学校的标识是什么？"]
["workInstitutions", "athletics"]	["entity的工作机构属于哪个协会？"]
["doctoralAdvisor", "doctoralStudents"]	["谁是entity的博士生导师的博士生？"]
["種族", "group"]	["entity的属于哪个组？"]
["territory", "north"]	["哪个城市位于entity覆盖的区域的北部？"]
["territory", "northeast"]	["位于entity覆盖的区域东北的地方是什么？"]
["country", "governmentType"]	["entity的政府类型是什么？"]
["studio", "industry"]	["制作entity的工作室所属的产业类型是什么？"]
["location", "southeast"]	["哪个城市位于entity的位置的东南部？"]
["predecessor", "connectivity"]	["entity的前代产品的连接性是什么？"]
["ground", "leaderTitle"]	["entity的地址在哪里作为leaderTitle？"]
["受影响于", "influenced"]	["谁影响了P对entity带来影响的人？"]
["受影响于", "children"]	["P对entity带来影响的人孩子的名字是什么？"]
["母校", "athletics"]	["entity的母校属于哪个协会？"]
["受影响于", "influences"]	["谁影响P对entity带来影响的人？"]
["before", "p"]	["如何用汉语拼音拼写entity的前任？","entity的前任的中文拼音是什么？"]
["binomialAuthority", "occupation"]	["entity的二项式命名法学名的从事的职业是什么？","entity的二项式命名法学名的的工作是什么？"]
["locationCity", "governmentType"]	["entity的所在地政府类型是什么？"]
["cup", "referee"]	["谁是entity获得的奖项的裁判？"]
["placeOfBirth", "ethnicGroups"]	["entity的出生地属于哪个民族？"]
["ground", "sovereigntyType"]	["什么是entity的地址的主权类型？"]
["state", "leaderTitle"]	["entity所在的州在哪里作为leaderTitle？"]
["母校", "affiliations"]	["entity的母校隶属于什么机构？"]
["播放地區", "ethnicGroups"]	["entity属于哪个民族？"]
["ground", "tenants"]	["哪个俱乐部entity的地址租给哪个？","哪个俱乐部做租客entity的地址？"]
["state", "highestpoint"]	["entity所在的州的最高点是什么？"]
["state", "mammal"]	["entity所在的州中濒临灭绝的哺乳动物是什么？"]
["platforms", "developer"]	["谁开发entity的发布平台？","谁是entity的发布平台的开发者？"]
["after", "spouse"]	["谁是entity的的配偶？"]
["title", "label"]	["entity的标题的标签是什么？"]
["origin", "legislature"]	["什么是entity的发源地的立法机关？"]
["stadium", "subdivisionType"]	["举办entity的体育场的行政级别是什么？"]
["stadium", "subdivisionName"]	["举办entity的体育场的细分名称是什么？"]
["locationCountry", "leaderTitle"]	["entity所在的国家在哪里作为leaderTitle？"]
["origin", "leaderTitle"]	["entity的发源地在哪里作为leaderTitle？"]
["ground", "areaCodeType"]	["entity的地址有哪些类型的区号？"]
["ground", "subdivisionType"]	["entity的地址的行政级别是什么？"]
["primeminister", "president"]	["谁是entity的首相的总裁？"]
["binomialAuthority", "nationality"]	["entity的二项式命名法学名的的国籍是什么？"]
["afterElection", "almaMater"]	["entity的胜选者从哪里毕业？"]
["director", "title"]	["什么是entity的导演的名字？"]
["capital", "leaderTitle"]	["entity的首都在哪里作为leaderTitle？"]
["placeOfBirth", "callingCode"]	["什么是entity的出生地中的调用代码？"]
["birthPlace", "demonym"]	["我们称之为entity的出生地的人是谁？"]
["birthPlace", "lieutenantGovernor"]	["谁是entity的出生地现任副州长？"]
["party", "affiliation"]	["谁隶属于entity所属的党派？"]
["arrondissement", "subdivisionType"]	["entity的行政级别是什么？"]
["播放地區", "officialLanguages"]	["entity的官方语言是什么？"]
["primeminister", "almaMater"]	["entity的首相从哪里毕业？"]
["producer", "children"]	["entity的制片人孩子的名字是什么？"]
["使用平臺", "updatemodel"]	["entity的发布平台更新模型的名称是什么？"]
["builder", "issue"]	["谁是entity的建造商的父母？"]
["popplace", "governingBody"]	["entity的主要分布区域的管理机构是什么？"]
["region", "leaderName"]	["谁是entity所在的行政区的领导者？"]
["arrondissement", "subdivisionName"]	["entity的细分名称是什么？"]
["locale", "governor"]	["谁是entityEV的所属地点的现任州长？"]
["身份", "religion"]	["entity所在的朝代的宗教是什么？"]
["managerclubs", "chairman"]	["谁是entity执教的俱乐部的主席？"]
["parent", "industry"]	["entity的主公司所属的产业类型是什么？"]
["電視網", "cableServ"]	["哪个公司播放entity的电视台属于？"]
["subdivisionName", "timezoneDst"]	["entity属于哪个时区？"]
["placeOfBirth", "establishedEvent"]	["什么时候entity的出生地创建既定事件？"]
["birthPlace", "leaderTitle"]	["entity的出生地在哪里作为leaderTitle？"]
["父親", "children"]	["entity的父亲孩子的名字是什么？"]
["parent", "logo"]	["entity的主公司的标识是什么？"]
["referee", "title"]	["什么是entity的裁判员的名字？"]
["states", "currency"]	["使用entity的地区的货币是什么？"]
["subdivisionName", "lowerhouse"]	["我们用什么名字打电话给entity的下院？"]
["binomialAuthority", "knownFor"]	["什么是entity的二项式命名法学名的知道的？"]
["music", "relatives"]	["谁是entity的配乐作者的亲戚？"]
["incumbent", "birthPlace"]	["entity的现任出生在哪里？"]
["label", "owner"]	["谁是entity的标签的所有者？"]
["lyrics", "before"]	["谁是entity的的上一任？"]
["birthPlace", "timezone1Dst"]	["entity的出生地属于哪个时区？"]
["birthPlace", "religion"]	["entity的出生地的宗教是什么？"]
["播放地區", "leaderName"]	["谁是entity的领导者？"]
["venue", "owner"]	["谁是entity的举办场地的所有者？"]
["播放地區", "sovereigntyType"]	["什么是entity的主权类型？"]
["播放地區", "legislature"]	["什么是entity的立法机关？"]
["family", "child"]	["什么属于entity所属的家族？"]
["leaderParty", "successor"]	["谁是entity的的继承人？"]
["constell", "neareststarname"]	["从entity所属于的星座到地球的最近的恒星是什么？"]
["出生地點", "regionalLanguages"]	["哪种语言是entity的出生地点中的区域语言？"]
["location", "lieutenantGovernor"]	["谁是entity的位置现任副州长？"]
["location", "soil"]	["entity的位置的州土壤是什么？"]
["出生地", "establishedEvent"]	["什么时候entity的出生地创建既定事件？"]
["父親", "before"]	["谁是entity的父亲的上一任？"]
["citizenship", "callingCode"]	["什么是entity的公民身份中的调用代码？"]
["countryAdminDivisions", "translitLang1Type"]	["什么是entity的翻译方案？"]
["birthPlace", "legislature"]	["什么是entity的出生地的立法机关？"]
["studio", "founder"]	["谁是制作entity的工作室的创始人？","谁创立了制作entity的工作室？"]
["territory", "subdivisionName"]	["entity覆盖的区域的细分名称是什么？"]
["commander", "office"]	["entity的将领的职务是什么？"]
["製作", "founder"]	["谁是entity的制作方的创始人？","谁创立了entity的制作方？"]
["channel", "cableServ"]	["哪个公司entity的电视台属于？"]
["manufacturer", "subsid"]	["entity的生产商子公司的名称是什么？"]
["designer", "children"]	["entity的设计者孩子的名字是什么？"]
["placeOfBirth", "officialReligion"]	["哪一项是entity的出生地第一修正案的宗教条款中规定的受宪法保护的权利？"]
["successor", "legislature"]	["什么是entity的一CLPM代产品的立法机关？"]
["founder", "birthPlace"]	["entity的创始人出生在哪里？"]
["president", "office"]	["entity效力的总统的职务是什么？"]
["primeminister", "successor"]	["谁是entity的首相的继承人？"]
["primeminister", "birthPlace"]	["entity的首相出生在哪里？"]
["primeminister", "before"]	["谁是entity的首相的上一任？"]
["地址", "postalCodeType"]	["entity的地址使用什么类型的邮政编码？"]
["starring", "influenced"]	["谁影响了参演entity的演员？"]
["office", "president"]	["谁是entity担任的要职的总裁？"]
["office", "ideology"]	["什么是entity担任的要职的政治意识形态？"]
["predecessor", "honorificSuffix"]	["entity的前代产品的敬语后缀是什么？"]
["birthPlace", "areaCodeType"]	["entity的出生地有哪些类型的区号？"]
["primeminister", "spouse"]	["谁是entity的首相的配偶？"]
["primeminister", "chancellor"]	["谁是entity的首相的总理？"]
["stadium", "southwest"]	["位于举办entity的体育场西南的是什么？"]
["platforms", "connectivity"]	["entity的发布平台的连接性是什么？"]
["products", "developer"]	["谁开发entity的产品？","谁是entity的产品的开发者？"]
["country", "legislature"]	["什么是entity的的立法机关？"]
["動畫製作", "industry"]	["entity的动画所属的产业类型是什么？"]
["workInstitutions", "almaMater"]	["entity的工作机构从哪里毕业？"]
["location", "subdivisionName"]	["entity的位置的细分名称是什么？"]
["location", "leaderParty"]	["什么是entity的位置的领导方？"]
["birthPlace", "northeast"]	["位于entity的出生地东北的地方是什么？"]
["region", "establishedEvent"]	["什么时候entity所在的行政区创建既定事件？"]
["author", "doctoralStudents"]	["谁是entity的原著作者的博士生？"]
["territory", "upperhouse"]	["我们用什么名字来称呼entity覆盖的区域的上院？"]
["country", "sovereigntyType"]	["什么是entity的的主权类型？"]
["combatant", "currency"]	["entity的货币是什么？"]
["主持", "label"]	["entity的主持人的标签是什么？"]
["location", "postalCodeType"]	["entity的位置使用什么类型的邮政编码？"]
["residence", "postalCode"]	["什么是entity的居住地的邮政编码？"]
["primeminister", "honorificPrefix"]	["entity的首相的荣誉称号是什么？"]
["ground", "ethnicGroups"]	["entity的地址属于哪个民族？"]
["cities", "leaderName"]	["谁是entity的领导者？"]
["basinCountries", "demonym"]	["我们称之为entity的沿线国家的人是谁？"]
["location", "postalCode"]	["什么是entity的位置的邮政编码？"]
["location", "southwest"]	["位于entity的位置西南的是什么？"]
["countryofbirth", "legislature"]	["什么是entity的祖国的立法机关？"]
["state", "governor"]	["谁是entity所在的州的现任州长？"]
["manufacturer", "title"]	["什么是entity的生产商的名字？"]
["subdivisionName", "location"]	["entity在哪里？"]
["before", "subdivisionType"]	["entity的前任的行政级别是什么？"]
["artist", "title"]	["什么是发布entity的艺人的名字？"]
["stadium", "governingBody"]	["举办entity的体育场的管理机构是什么？"]
["headquarters", "southwest"]	["位于entity的总部地址西南的是什么？"]
["notableCommanders", "deathPlace"]	["entity的著名指挥官死在哪里？","entity的著名指挥官的死亡地点是什么？"]
["主唱", "label"]	["entity的主唱的标签是什么？"]
["builder", "type"]	["哪种类型是entity的建造商？"]
["commonLanguages", "sign"]	["entity的通用语言使用什么样的语言？"]
["語言", "ancestor"]	["entity使用的语言的祖先在哪里？"]
["artist", "ancestry"]	["发布entity的艺人的家人来自哪里？","发布entity的艺人的故乡是什么？"]
["office", "leader"]	["谁是entity担任的要职的领导者？"]
["locale", "timezoneDst"]	["entityEV的所属地点属于哪个时区？"]
["locale", "establishedTitle"]	["哪个法律","行为使entityEV的所属地点成立？"]
["locale", "areaCodeType"]	["entityEV的所属地点有哪些类型的区号？"]
["owner", "leaderTitle"]	["entity的总裁在哪里作为leaderTitle？"]
["successor", "type"]	["哪种类型是entity的一CLPM代产品？"]
["placeOfBirth", "event"]	["哪个文件","事件影响了entity的出生地的灭绝并在欧洲结束了第二次世界大战？"]
["placeOfDeath", "callingCode"]	["什么是entity的逝世地址中的调用代码？"]
["president", "almaMater"]	["entity效力的总统从哪里毕业？"]
["distributor", "owner"]	["谁是entity的发行商的所有者？"]
["producer", "education"]	["entity的制片人毕业的地方？","entity的制片人从哪个学校毕业？"]
["start", "subdivisionType"]	["entity的起点站的行政级别是什么？"]
["placeOfBirth", "leader"]	["谁是entity的出生地的领导者？"]
["developer", "services"]	["什么包含在entity的开发商的服务中？"]
["territory", "soil"]	["entity覆盖的区域的州土壤是什么？"]
["territory", "bird"]	["哪种鸟类生物居住在entity覆盖的区域？"]
["district", "subdivisionType"]	["entity所在的区域的行政级别是什么？"]
["locale", "settlementType"]	["entityEV的所属地点属于哪个地区？"]
["managerclubs", "referee"]	["谁是entity执教的俱乐部的裁判？"]
["office", "settlementType"]	["entity担任的要职属于哪个地区？"]
["office", "areaCodeType"]	["entity担任的要职有哪些类型的区号？"]
["office", "p"]	["如何用汉语拼音拼写entity担任的要职？","entity担任的要职的中文拼音是什么？"]
["education", "affiliations"]	["entity隶属于什么机构？"]
["manufacturer", "location"]	["entity的生产商在哪里？"]
["showName", "executiveProducer"]	["谁是entity的展示名的执行制片人？"]
["showName", "genre"]	["entity的展示名属于哪种类型？"]
["vicepresident", "title"]	["什么是entity的副总统的名字？"]
["commander", "spouse"]	["谁是entity的将领的配偶？"]
["binomialAuthority", "mayor"]	["谁是entity的二项式命名法学名的的市长？"]
["territory", "title"]	["什么是entity覆盖的区域的名字？"]
["influences", "genre"]	["entity的人属于哪种类型？"]
["doctoralAdvisor", "before"]	["谁是entity的博士生导师的上一任？"]
["venue", "leaderName"]	["谁是entity的举办场地的领导者？"]
["territory", "lieutenantGovernor"]	["谁是entity覆盖的区域现任副州长？"]
["line", "type"]	["哪种类型是entity的地铁线？"]
["binomialAuthority", "leaderName"]	["谁是entity的二项式命名法学名的的领导者？"]
["residence", "tartan"]	["什么是entity的居住地的官方苏格兰格子呢模式？"]
["使用平台", "sourceModel"]	["哪一个是entity的使用平台的源模型？"]
["stadium", "northeast"]	["位于举办entity的体育场东北的地方是什么？"]
["locale", "demonym"]	["我们称之为entityEV的所属地点的人是谁？"]
["locale", "timezone"]	["entityEV的所属地点属于哪个时区？"]
["prevSeason", "writtenby"]	["谁写过entity的？","谁是entity的的作者？"]
["leader", "spouse"]	["谁是entity的领导人的配偶？"]
["territory", "tartan"]	["什么是entity覆盖的区域的官方苏格兰格子呢模式？"]
["territory", "grass"]	["什么样的草原产于entity覆盖的区域？"]
["father", "deathPlace"]	["entity的父亲死在哪里？","entity的父亲的死亡地点是什么？"]
["音樂類型", "derivatives"]	["什么是entity的音乐类型的衍生物？"]
["出生地", "postalCodeType"]	["entity的出生地使用什么类型的邮政编码？"]
["series", "genre"]	["entity属于哪种类型？"]
["author", "almaMater"]	["entity的原著作者从哪里毕业？"]
["leader", "predecessor"]	["谁是entity的领导人的前身？"]
["namedAfter", "knownFor"]	["什么是entity的名字知道的？"]
["distributor", "iptvServ"]	["entity的发行商推广什么样的IPTV服务？"]
["territory", "butterfly"]	["在entity覆盖的区域中发现了什么样的蝴蝶？"]
["territory", "legislature"]	["什么是entity覆盖的区域的立法机关？"]
["territory", "largestmetro"]	["entity覆盖的区域最大的地铁在哪里？"]
["popplace", "grass"]	["什么样的草原产于entity的主要分布区域？"]
["popplace", "fish"]	["什么是entity的主要分布区域中的州鱼？"]
["primaryUser", "officialLanguages"]	["entity的主要用户的官方语言是什么？"]
["inaugural", "title"]	["什么是就职entity的政客的名字？"]
["after", "alongside"]	["谁像entity的一样出名？","谁与entity的同样出名？"]
["areaServed", "ethnicGroups"]	["entity的服务区域属于哪个民族？"]
["workplaces", "president"]	["谁是entity的工作地点的总裁？"]
["placeOfDeath", "legislature"]	["什么是entity的逝世地址的立法机关？"]
["placeOfDeath", "establishedEvent"]	["什么时候entity的逝世地址创建既定事件？"]
["party", "logo"]	["entity所属的党派的标识是什么？"]
["educate", "affiliations"]	["entity隶属于什么机构？"]
["predecessor", "president"]	["谁是entity的前代产品的总裁？"]
["时代", "leader"]	["谁是entity哪个时代的领导者？"]
["subdivisionName", "languages"]	["谁使用entity的区域语言？"]
["city", "leaderParty"]	["什么是entity的所在城市的领导方？"]
["代表作", "language"]	["entity的代表作品的语言是什么？"]
["播放地區", "northwest"]	["哪个地方位于entity的西北部？"]
["mainStations", "operator"]	["哪个公司entity的主要站点属于？"]
["locale", "populationBlank1Title"]	["什么是entityEV的所属地点？"]
["alongside", "predecessor"]	["谁是P与entityA同时在任的政客的前身？"]
["father", "title"]	["什么是entity的父亲的名字？"]
["動畫製作", "type"]	["哪种类型是entity的动画？"]
["ground", "leaderName"]	["谁是entity的地址的领导者？"]
["usedBy", "leaderName"]	["谁是entity的使用者的领导者？"]
["usedBy", "governmentType"]	["entity的使用者政府类型是什么？"]
["usedBy", "legislature"]	["什么是entity的使用者的立法机关？"]
["locationCountry", "label"]	["entity所在的国家的标签是什么？"]
["ground", "upperHouse"]	["什么是entity的地址的上议院？"]
["ground", "callingCode"]	["什么是entity的地址中的调用代码？"]
["commander", "religion"]	["entity的将领的宗教是什么？"]
["主演", "ancestry"]	["entity的演员的家人来自哪里？","entity的演员的故乡是什么？"]
["debutteam", "list3."]	["entity的O第一CLPM支球队为之奋斗的第三支职业球队是什么？"]
["finalteam", "list3."]	["entity效力的最后一CLPM支球队为之奋斗的第三支职业球队是什么？"]
["country", "title"]	["什么是entity的的名字？"]
["champion", "chairman"]	["谁是entity的总冠军的主席？"]
["label", "timezone"]	["entity的标签属于哪个时区？"]
["country", "languages"]	["谁使用entity的的区域语言？"]
["platforms", "family"]	["谁是entity的发布平台的家人？","谁是entity的发布平台的父亲？"]
["location", "north"]	["哪个城市位于entity的位置的北部？"]
["ground", "languages"]	["谁使用entity的地址的区域语言？"]
["動畫製作", "logo"]	["entity的动画的标识是什么？"]
["influences", "birthPlace"]	["entity的人出生在哪里？"]
["managerclubs", "club"]	["哪个俱乐部属于entity执教的俱乐部？"]
["workplaces", "keyPeople"]	["谁是entity的工作地点的首席执行官？"]
["predecessor", "children"]	["entity的前代产品孩子的名字是什么？"]
["country", "deputy"]	["谁是entity的的部长？"]
["代表作", "writer"]	["谁写过entity的代表作品？","谁是entity的代表作品的作者？"]
["areas", "leaderName"]	["谁是entity的领导者？"]
["citizenship", "upperHouse"]	["什么是entity的公民身份的上议院？"]
["starring", "currentMembers"]	["谁是参演entity的演员的现任乐队领队？"]
["唱片公司", "divisions"]	["哪个唱片公司的entity与entity哪家唱片公司拥有？"]
["monarch", "as"]	["entity相当于什么？"]
["founder", "children"]	["entity的创始人孩子的名字是什么？"]
["workInstitution", "provost"]	["谁是entity的工作机构的教务长？"]
["自治體", "subdivisionType"]	["entity的地方政府的行政级别是什么？"]
["managerclubs", "location"]	["entity执教的俱乐部在哪里？"]
["region", "seat"]	["发现entity所在的行政区的地方是什么？"]
["region", "seatType"]	["entity所在的行政区的行政级别是什么？"]
["籍貫", "timezone"]	["entity的籍贯属于哪个时区？"]
["successor", "children"]	["entity的一CLPM代产品孩子的名字是什么？"]
["commander", "children"]	["entity的将领孩子的名字是什么？"]
["developer", "divisions"]	["哪个唱片公司的entity的开发商拥有？"]
["region", "label"]	["entity所在的行政区的标签是什么？"]
["workInstitutions", "president"]	["谁是entity的工作机构的总裁？"]
["製作", "format"]	["entity的制作方的格式是什么？"]
["influenced", "influenced"]	["谁影响了受到entity影响的人？"]
["combatant", "ethnicGroups"]	["entity属于哪个民族？"]
["issue", "father"]	["谁是entity的后裔的父亲？"]
["usedBy", "ethnicGroups"]	["entity的使用者属于哪个民族？"]
["programmingLanguage", "developer"]	["谁开发entity的开发语言？","谁是entity的开发语言的开发者？"]
["religion", "languages"]	["谁使用entity信仰的区域语言？"]
["usedBy", "regionalLanguages"]	["哪种语言是entity的使用者中的区域语言？"]
["managerclubs", "coach"]	["谁是entity执教的俱乐部的现任经理？"]
["leader", "succession"]	["谁是entity的领导人的继承人？"]
["deputy", "before"]	["谁是entity的代理人的上一任？"]
["locale", "northeast"]	["位于entityEV的所属地点东北的地方是什么？"]
["moreUsers", "establishedEvent"]	["什么时候使用entity的国家创建既定事件？"]
["writer", "before"]	["谁是entity的作者的上一任？"]
["出生地", "leaderName"]	["谁是entity的出生地的领导者？"]
["出生地", "postalCode"]	["什么是entity的出生地的邮政编码？"]
["predecessor", "father"]	["谁是entity的前代产品的父亲？"]
["代表作", "starring"]	["谁主演entity的代表作品？"]
["自治體", "settlementType"]	["entity的地方政府属于哪个地区？"]
["deputy", "title"]	["什么是entity的代理人的名字？"]
["precededBy", "title"]	["什么是entity的一CLPM部作品的名字？"]
["workInstitution", "type"]	["哪种类型是entity的工作机构？"]
["subdivisionName", "settlementType"]	["entity属于哪个地区？"]
["branch", "commander"]	["我们应该称之为entity的的指挥官？"]
["winners", "chairman"]	["谁是entity的冠军队伍的主席？"]
["官方語言", "ancestor"]	["entity的官方语言的祖先在哪里？"]
["starring", "family"]	["谁是参演entity的演员的家人？","谁是参演entity的演员的父亲？"]
["youthclubs", "owner"]	["谁是entity所属青年俱乐部的所有者？"]
["issue", "deathPlace"]	["entity的后裔死在哪里？","entity的后裔的死亡地点是什么？"]
["workInstitution", "president"]	["谁是entity的工作机构的总裁？"]
["workInstitution", "nickname"]	["entity的工作机构的昵称是什么？"]
["after", "office"]	["entity的的职务是什么？"]
["primeminister", "honorificSuffix"]	["entity的首相的敬语后缀是什么？"]
["lyrics", "placeOfBirth"]	["entity的出生在哪里？"]
["music", "placeOfBirth"]	["entity的配乐作者出生在哪里？"]
["artist", "origin"]	["发布entity的艺人的起源是什么？"]
["beforeElection", "predecessor"]	["谁是entity一CLPM任领导人的前身？"]
["beforeElection", "spouse"]	["谁是entity一CLPM任领导人的配偶？"]
["军阶", "aircraftTransport"]	["什么是entity的军阶的飞机运输？"]
["军阶", "commander"]	["我们应该称之为entity的军阶的指挥官？"]
["leaderName", "timezoneDst"]	["entity的领导人属于哪个时区？"]
["primaryUser", "commander"]	["我们应该称之为entity的主要用户的指挥官？"]
["主唱", "children"]	["entity的主唱孩子的名字是什么？"]
["country", "leaderTitle"]	["entity的在哪里作为leaderTitle？"]
["operatingSystem", "sourceModel"]	["哪一个是entity的操作系统的源模型？"]
["precededBy", "genre"]	["entity的一CLPM部作品属于哪种类型？"]
["incumbent", "office"]	["entity的现任的职务是什么？"]
["location", "timezoneDst"]	["entity的位置属于哪个时区？"]
["writer", "influenced"]	["谁影响了entity的作者？"]
["writer", "influences"]	["谁影响entity的作者？"]
["播放地區", "establishedEvent"]	["什么时候entity创建既定事件？"]
["lyrics", "genre"]	["entity的属于哪种类型？"]
["precededBy", "producer"]	["谁是entity的一CLPM部作品的制片人？"]
["經紀公司", "owner"]	["谁是entity的经济公司的所有者？"]
["nominee", "office"]	["entity的提名人的职务是什么？"]
["influencedBy", "influencedBy"]	["谁影响P对entity产生影响的编码语言？"]
["location", "largestmetro"]	["entity的位置最大的地铁在哪里？"]
["deathPlace", "ethnicGroups"]	["entity逝世的地方属于哪个民族？"]
["youthclubs", "league"]	["哪个联盟entity所属青年俱乐部属于哪个？"]
["deathPlace", "regionalLanguages"]	["哪种语言是entity逝世的地方中的区域语言？"]
["successor", "primeminister"]	["谁是entity的一CLPM代产品的首相？"]
["spouse", "predecessor"]	["谁是entity的配偶的前身？"]
["ground", "religion"]	["entity的地址的宗教是什么？"]
["winners", "owner"]	["谁是entity的冠军队伍的所有者？"]
["after", "honorificPrefix"]	["entity的的荣誉称号是什么？"]
["office", "youthWing"]	["entity担任的要职的青年翼是什么？"]
["producer", "family"]	["谁是entity的制片人的家人？","谁是entity的制片人的父亲？"]
["workInstitution", "logo"]	["entity的工作机构的标识是什么？"]
["workInstitutions", "industry"]	["entity的工作机构所属的产业类型是什么？"]
["nationality", "lowerHouse"]	["什么是entity的国籍的下议院？"]
["subdivisionName", "bird"]	["哪种鸟类生物居住在entity？"]
["自治體", "tree"]	["什么树大部分种植在entity的地方政府？"]
["college", "chancellor"]	["谁是entity所就读的大学的总理？"]
["location", "isoCode"]	["什么是entity的位置的ISO代码？"]
["manufacturer", "author"]	["谁是entity的生产商的作者？"]
["自治體", "governor"]	["谁是entity的地方政府的现任州长？"]
["自治體", "bird"]	["哪种鸟类生物居住在entity的地方政府？"]
["deathPlace", "southwest"]	["位于entity逝世的地方西南的是什么？"]
["所在", "governmentType"]	["entity所在的城市政府类型是什么？"]
["nationality", "governmentType"]	["entity的国籍政府类型是什么？"]
["currentMembers", "occupation"]	["entity的现任成员从事的职业是什么？","entity的现任成员的工作是什么？"]
["currentMembers", "genre"]	["entity的现任成员属于哪种类型？"]
["predecessor", "mother"]	["谁是entity的前代产品的母亲？"]
["commonLanguages", "child"]	["什么属于entity的通用语言？"]
["allegiance", "legislature"]	["什么是entity的立法机关？"]
["residence", "demonym"]	["我们称之为entity的居住地的人是谁？"]
["nationalteam", "before"]	["谁是entity的上一任？"]
["stylisticOrigins", "instruments"]	["entity的风格源头使用什么工具？"]
["states", "governmentType"]	["使用entity的地区政府类型是什么？"]
["father", "spouse"]	["谁是entity的父亲的配偶？"]
["areas", "demonym"]	["我们称之为entity的人是谁？"]
["areas", "regionalLanguages"]	["哪种语言是entity中的区域语言？"]
["headquarters", "establishedEvent"]	["什么时候entity的总部地址创建既定事件？"]
["successor", "succession"]	["谁是entity的一CLPM代产品的继承人？"]
["starring", "ancestry"]	["参演entity的演员的家人来自哪里？","参演entity的演员的故乡是什么？"]
["起點站", "title"]	["什么是entity的起点站的名字？"]
["incumbent", "primeminister"]	["谁是entity的现任的首相？"]
["countryofbirth", "officialLanguages"]	["entity的祖国的官方语言是什么？"]
["currentMembers", "notableInstruments"]	["哪种乐器entity的现任成员发挥并因此而闻名？"]
["spouse", "honorificPrefix"]	["entity的配偶的荣誉称号是什么？"]
["spouse", "almaMater"]	["entity的配偶从哪里毕业？"]
["producer", "influences"]	["谁影响entity的制片人？"]
["前一站", "operator"]	["哪个公司entity的前一站属于？"]
["後一站", "operator"]	["哪个公司entity的后一站属于？"]
["predecessor", "party"]	["entity的前代产品属于哪一方？"]
["successor", "event"]	["哪个文件","事件影响了entity的一CLPM代产品的灭绝并在欧洲结束了第二次世界大战？"]
["教育程度", "president"]	["谁是entity的毕业学校的总裁？"]
["birthplace", "soil"]	["entityO第一CLPM支登场的球队的州土壤是什么？"]
["developer", "successor"]	["谁是entity的开发商的继承人？"]
["自治體", "leaderTitle"]	["entity的地方政府在哪里作为leaderTitle？"]
["developer", "logo"]	["entity的开发商的标识是什么？"]
["自治體", "fish"]	["什么是entity的地方政府中的州鱼？"]
["籍貫", "governor"]	["谁是entity的籍贯的现任州长？"]
["主演", "birthPlace"]	["entity的演员出生在哪里？"]
["title", "affiliation"]	["谁隶属于entity的标题？"]
["founder", "predecessor"]	["谁是entity的创始人的前身？"]
["代表作", "producer"]	["谁是entity的代表作品的制片人？"]
["birthPlace", "subdivisionType"]	["entity的出生地的行政级别是什么？"]
["placeOfDeath", "titleLeader"]	["entity的逝世地址中领导者的头衔是什么？"]
["birthPlace", "amphibian"]	["什么是IUCN脆弱的物种？青蛙？在entity的出生地？"]
["birthPlace", "dance"]	["entity的出生地的官方舞蹈是什么？"]
["title", "leaderName"]	["谁是entity的标题的领导者？"]
["birthPlace", "government"]	["entity的出生地所属政府形式是什么？"]
["subdivisionName", "officialReligion"]	["哪一项是entity第一修正案的宗教条款中规定的受宪法保护的权利？"]
["seat", "leaderTitle"]	["entity的行政中心在哪里作为leaderTitle？"]
["subdivisionName", "dance"]	["entity的官方舞蹈是什么？"]
["before", "alongside"]	["谁像entity的前任一样出名？","谁与entity的前任同样出名？"]
["predecessor", "religion"]	["entity的前代产品的宗教是什么？"]
["almaMater", "founder"]	["谁是entity的母校的创始人？","谁创立了entity的母校？"]
["cities", "subdivisionName"]	["entity的细分名称是什么？"]
["countryofbirth", "demonym"]	["我们称之为entity的祖国的人是谁？"]
["currentclub", "owner"]	["谁是entity的所有者？"]
["birthPlace", "lowerHouse"]	["什么是entity的出生地的下议院？"]
["influences", "children"]	["entity的人孩子的名字是什么？"]
["deathPlace", "governor"]	["谁是entity逝世的地方的现任州长？"]
["出生地點", "southeast"]	["哪个城市位于entity的出生地点的东南部？"]
["自治體", "leaderName"]	["谁是entity的地方政府的领导者？"]
["plat", "updatemodel"]	["entity的发布平台更新模型的名称是什么？"]
["birthPlace", "timezone"]	["entity的出生地属于哪个时区？"]
["deathPlace", "leaderTitle"]	["entity逝世的地方在哪里作为leaderTitle？"]
["languages", "fam"]	["entity使用的语言属于哪种语言？"]
["affiliation", "chancellor"]	["谁是entity的隶属机构的总理？"]
["deathPlace", "grass"]	["什么样的草原产于entity逝世的地方？"]
["現任成員", "associatedActs"]	["谁与entity的现任成员相关联？"]
["nationality", "sovereigntyType"]	["什么是entity的国籍的主权类型？"]
["workplaces", "logo"]	["entity的工作地点的标识是什么？"]
["incumbent", "title"]	["什么是entity的现任的名字？"]
["starring", "placeOfBirth"]	["参演entity的演员出生在哪里？"]
["party", "caption"]	["entity所属的党派的标识是什么？"]
["country", "lowerHouse"]	["什么是entity的的下议院？"]
["platforms", "label"]	["entity的发布平台的标签是什么？"]
["電視網", "owner"]	["谁是播放entity的电视台的所有者？"]
["region", "subdivisionType"]	["entity所在的行政区的行政级别是什么？"]
["region", "settlementType"]	["entity所在的行政区属于哪个地区？"]
["主唱", "genre"]	["entity的主唱属于哪种类型？"]
["combatant", "birthPlace"]	["entity出生在哪里？"]
["countryAdminDivisions", "leaderName"]	["谁是entity的领导者？"]
["combatant", "legislature"]	["什么是entity的立法机关？"]
["president", "birthPlace"]	["entity效力的总统出生在哪里？"]
["alongside", "title"]	["什么是P与entityA同时在任的政客的名字？"]
["starring", "associatedActs"]	["谁与参演entity的演员相关联？"]
["currentclub", "lcm"]	["谁是entity的新QPR英雄？"]
["popplace", "ethnicGroups"]	["entity的主要分布区域属于哪个民族？"]
["birthPlace", "postalCode"]	["什么是entity的出生地的邮政编码？"]
["birthPlace", "governingBody"]	["entity的出生地的管理机构是什么？"]
["almaMater", "chairman"]	["谁是entity的母校的主席？"]
["deputy", "issue"]	["谁是entity的代理人的父母？"]
["successor", "party"]	["entity的一CLPM代产品属于哪一方？"]
["almaMater", "provost"]	["谁是entity的母校的教务长？"]
["fromAlbum", "writer"]	["谁写过entity的一CLPM部专辑？","谁是entity的一CLPM部专辑的作者？"]
["music", "spouse"]	["谁是entity的配乐作者的配偶？"]
["primeminister", "office"]	["entity的首相的职务是什么？"]
["頻道", "satServ"]	["什么是放映entity的频道的母公司？"]
["cityofbirth", "establishedTitle"]	["哪个法律","行为使entity的出生地成立？"]
["director", "genre"]	["entity的导演属于哪种类型？"]
["prev", "office"]	["entity的的职务是什么？"]
["state", "legislature"]	["什么是entity所在的州的立法机关？"]
["before", "parents"]	["谁养育了entity的前任？","谁把entity的前任抚养长大？","谁是entity的前任的父母？"]
["subdivisionName", "timezone1Dst"]	["entity属于哪个时区？"]
["subdivisionName", "subdivisionType"]	["entity的行政级别是什么？"]
["subdivisionName", "blank1NameSec"]	["entity属于什么？"]
["after", "party"]	["entity的属于哪一方？"]
["after", "president"]	["谁是entity的的总裁？"]
["owner", "affiliations"]	["entity的总裁隶属于什么机构？"]
["subdivisionName", "leaderParty"]	["什么是entity的领导方？"]
["areas", "upperHouse"]	["什么是entity的上议院？"]
["before", "president"]	["谁是entity的前任的总裁？"]
["youthclubs", "ground"]	["entity所属青年俱乐部的主场在哪里？"]
["stadium", "leaderParty"]	["什么是举办entity的体育场的领导方？"]
["subdivisionName", "region"]	["entity属于哪个列表？","哪个列表包含entity？"]
["subdivisionName", "capital"]	["entity的首都在哪里？"]
["subdivisionName", "officialLanguages"]	["entity的官方语言是什么？"]
["monarch", "mother"]	["谁是entity的母亲？"]
["before", "successor"]	["谁是entity的前任的继承人？"]
["canonizedBy", "bishop"]	["谁是entity的的主教？"]
["fam", "script"]	["什么是entity的的盲文？"]
["doctoralAdvisor", "influenced"]	["谁影响了entity的博士生导师？"]
["owner", "divisions"]	["哪个唱片公司的entity的总裁拥有？"]
["locationCity", "title"]	["什么是entity的所在地的名字？"]
["battles", "commander"]	["我们应该称之为entity参加的战争的指挥官？"]
["district", "candidate"]	["谁是entity所在的区域的候选人？"]
["相關團體", "genre"]	["entity的相关团体属于哪种类型？"]
["afterElection", "deputy"]	["谁是entity的胜选者的部长？"]
["influenced", "birthPlace"]	["受到entity影响的人出生在哪里？"]
["influenced", "issue"]	["谁是受到entity影响的人的父母？"]
["combatant", "leader"]	["谁是entity的领导者？"]
["branch", "aircraftTransport"]	["什么是entity的的飞机运输？"]
["influenced", "title"]	["什么是受到entity影响的人的名字？"]
["ethnicity", "languages"]	["谁使用entity的区域语言？"]
["state", "establishedTitle"]	["哪个法律","行为使entity所在的州成立？"]
["state", "leaderName"]	["谁是entity所在的州的领导者？"]
["deathPlace", "leaderName"]	["谁是entity逝世的地方的领导者？"]
["state", "postalCodeType"]	["entity所在的州使用什么类型的邮政编码？"]
["writer", "children"]	["entity的作者孩子的名字是什么？"]
["deputy", "spouse"]	["谁是entity的代理人的配偶？"]
["primaryUser", "type"]	["哪种类型是entity的主要用户？"]
["moreUsers", "demonym"]	["我们称之为使用entity的国家的人是谁？"]
["father", "alongside"]	["谁像entity的父亲一样出名？","谁与entity的父亲同样出名？"]
["spouse", "before"]	["谁是entity的配偶的上一任？"]
["after", "religion"]	["entity的的宗教是什么？"]
["combatant", "titleLeader"]	["entity中领导者的头衔是什么？"]
["platform", "manufacturer"]	["什么是entity的运行平台的制造商？","谁制作了entity的运行平台？"]
["before", "children"]	["entity的前任孩子的名字是什么？"]
["動畫製作", "owner"]	["谁是entity的动画的所有者？"]
["title", "ideology"]	["什么是entity的标题的政治意识形态？"]
["title", "leaderTitle"]	["entity的标题在哪里作为leaderTitle？"]
["president", "before"]	["谁是entity效力的总统的上一任？"]
["origin", "event"]	["哪个文件","事件影响了entity的发源地的灭绝并在欧洲结束了第二次世界大战？"]
["locationCountry", "leaderName"]	["谁是entity所在的国家的领导者？"]
["headquarters", "architect"]	["谁是entity的总部地址的建筑师？","谁建立了entity的总部地址？"]
["order", "establishedEvent"]	["什么时候P由entity担任领导的机构创建既定事件？"]
["headquarters", "northwest"]	["哪个地方位于entity的总部地址的西北部？"]
["areaServed", "label"]	["entity的服务区域的标签是什么？"]
["developer", "type"]	["哪种类型是entity的开发商？"]
["studio", "owner"]	["谁是制作entity的工作室的所有者？"]
["after", "leaderName"]	["谁是entity的的领导者？"]
["cities", "p"]	["如何用汉语拼音拼写entity？","entity的中文拼音是什么？"]
["placeOfDeath", "event"]	["哪个文件","事件影响了entity的逝世地址的灭绝并在欧洲结束了第二次世界大战？"]
["主唱", "title"]	["什么是entity的主唱的名字？"]
["subdivisionName", "fish"]	["什么是entity中的州鱼？"]
["champion", "list2."]	["谁是1904年entity的总冠军最好的右手投手？"]
["locationCity", "leaderTitle"]	["entity的所在地在哪里作为leaderTitle？"]
["before", "mother"]	["谁是entity的前任的母亲？"]
["producer", "currentMembers"]	["谁是entity的制片人的现任乐队领队？"]
["cities", "postalCode"]	["什么是entity的邮政编码？"]
["areaServed", "lowerHouse"]	["什么是entity的服务区域的下议院？"]
["fromAlbum", "producer"]	["谁是entity的一CLPM部专辑的制片人？"]
["almaMater", "almaMater"]	["entity的母校从哪里毕业？"]
["influences", "placeOfDeath"]	["entity的人死在哪里？","这是entity的人的死亡地点？"]
["民族", "establishedEvent"]	["什么时候entity所属的民族创建既定事件？"]
["label", "type"]	["哪种类型是entity的标签？"]
["place", "postalCodeType"]	["entity的地址使用什么类型的邮政编码？"]
["演出", "knownFor"]	["什么是出演entity的演员知道的？"]
["現任成員", "label"]	["entity的现任成员的标签是什么？"]
["combatant", "developer"]	["谁开发entity？","谁是entity的开发者？"]
["origin", "house"]	["entity的发源地有什么样的立法机构？"]
["writer", "title"]	["什么是entity的作者的名字？"]
["唱片公司", "keyPeople"]	["谁是entity与entity哪家唱片公司的首席执行官？"]
["namedAfter", "leaderTitle"]	["entity的名字在哪里作为leaderTitle？"]
["语言", "sign"]	["entity所使用的语言使用什么样的语言？"]
["placeOfBirth", "currency"]	["entity的出生地的货币是什么？"]
["製作", "owner"]	["谁是entity的制作方的所有者？"]
["district", "label"]	["entity所在的区域的标签是什么？"]
["location", "currency"]	["entity的位置的货币是什么？"]
["birthPlace", "house"]	["entity的出生地有什么样的立法机构？"]
["after", "issue"]	["谁是entity的的父母？"]
["publisher", "owner"]	["谁是entity的出版商的所有者？"]
["party", "wing"]	["女性的entity所属的党派翼是什么？"]
["代表作", "executiveProducer"]	["谁是entity的代表作品的执行制片人？"]
["deathplace", "region"]	["entity逝世的地方属于哪个列表？","哪个列表包含entity逝世的地方？"]
["areaServed", "demonym"]	["我们称之为entity的服务区域的人是谁？"]
["身份", "callingCode"]	["什么是entity所在的朝代中的调用代码？"]
["placeOfDeath", "subdivisionType"]	["entity的逝世地址的行政级别是什么？"]
["usedBy", "upperHouse"]	["什么是entity的使用者的上议院？"]
["deathPlace", "legislature"]	["什么是entity逝世的地方的立法机关？"]
["branch", "type"]	["哪种类型是entity的？"]
["issue", "title"]	["什么是entity的后裔的名字？"]
["predecessor", "eventEnd"]	["什么时候entity的前代产品解散了？"]
["title", "currentMembers"]	["谁是entity的标题的现任乐队领队？"]
["currentclub", "rcb"]	["谁是entity最强的玩家？"]
["platforms", "sourceModel"]	["哪一个是entity的发布平台的源模型？"]
["出生地", "languages"]	["谁使用entity的出生地的区域语言？"]
["director", "before"]	["谁是entity的导演的上一任？"]
["spouse", "succession"]	["谁是entity的配偶的继承人？"]
["出生地", "leaderTitle"]	["entity的出生地在哪里作为leaderTitle？"]
["出生地", "p"]	["如何用汉语拼音拼写entity的出生地？","entity的出生地的中文拼音是什么？"]
["出生地", "lowerHouse"]	["什么是entity的出生地的下议院？"]
["居住地", "establishedEvent"]	["什么时候entity的居住地创建既定事件？"]
["出生地", "legislature"]	["什么是entity的出生地的立法机关？"]
["出生地", "callingCode"]	["什么是entity的出生地中的调用代码？"]
["after", "house"]	["entity的有什么样的立法机构？"]
["allegiance", "leaderTitle"]	["entity在哪里作为leaderTitle？"]
["parent", "keyPeople"]	["谁是entity的主公司的首席执行官？"]
["leader", "occupation"]	["entity的领导人从事的职业是什么？","entity的领导人的工作是什么？"]
["afterElection", "honorificPrefix"]	["entity的胜选者的荣誉称号是什么？"]
["combatant", "type"]	["哪种类型是entity？"]
["basinCountries", "leaderName"]	["谁是entity的沿线国家的领导者？"]
["afterElection", "as"]	["entity的胜选者相当于什么？"]
["使用平臺", "logo"]	["entity的发布平台的标识是什么？"]
["channel", "type"]	["哪种类型是entity的电视台？"]
["birthPlace", "title"]	["什么是entity的出生地的名字？"]
["stadium", "stadium"]	["举办entity的体育场在哪里训练？"]
["commander", "before"]	["谁是entity的将领的上一任？"]
["occupation", "callingCode"]	["什么是entity的职业中的调用代码？"]
["music", "children"]	["entity的配乐作者孩子的名字是什么？"]
["location", "seat"]	["发现entity的位置的地方是什么？"]
["place", "governmentType"]	["entity的地址政府类型是什么？"]
["經紀公司", "keyPeople"]	["谁是entity的经济公司的首席执行官？"]
["operator", "leaderName"]	["谁是entity的相关运营A方是的领导者？"]
["notableCommanders", "predecessor"]	["谁是entity的著名指挥官的前身？"]
["music", "currentMembers"]	["谁是entity的配乐作者的现任乐队领队？"]
["commander", "relatives"]	["谁是entity的将领的亲戚？"]
["commander", "affiliation"]	["谁隶属于entity的将领？"]
["cityofbirth", "north"]	["哪个城市位于entity的出生地的北部？"]
["頻道", "cableServ"]	["哪个公司放映entity的频道属于？"]
["出生地", "ethnicGroups"]	["entity的出生地属于哪个民族？"]
["父親", "issue"]	["谁是entity的父亲的父母？"]
["地址", "leaderTitle"]	["entity的地址在哪里作为leaderTitle？"]
["basinCountries", "ethnicGroups"]	["entity的沿线国家属于哪个民族？"]
["after", "as"]	["entity的相当于什么？"]
["educate", "type"]	["哪种类型是entity？"]
["subdivisionName", "religion"]	["entity的宗教是什么？"]
["youthclubs", "lcb"]	["谁是entity所属青年俱乐部的着名前球员？"]
["cup", "logo"]	["entity获得的奖项的标识是什么？"]
["唱片公司", "subsid"]	["entity与entity哪家唱片公司子公司的名称是什么？"]
["designer", "keyPeople"]	["谁是entity的设计者的首席执行官？"]
["使用平臺", "predecessor"]	["谁是entity的发布平台的前身？"]
["before", "caption"]	["entity的前任的标识是什么？"]
["location", "location"]	["entity的位置在哪里？"]
["place", "architect"]	["谁是entity的地址的建筑师？","谁建立了entity的地址？"]
["namedAfter", "subdivisionType"]	["entity的名字的行政级别是什么？"]
["notableCommanders", "placeOfBirth"]	["entity的著名指挥官出生在哪里？"]
["areaServed", "regionalLanguages"]	["哪种语言是entity的服务区域中的区域语言？"]
["areaServed", "establishedEvent"]	["什么时候entity的服务区域创建既定事件？"]
["leaderParty", "wing"]	["女性的entity的翼是什么？"]
["stadium", "timezone"]	["举办entity的体育场属于哪个时区？"]
["ground", "operator"]	["哪个公司entity的地址属于？"]
["父親", "succession"]	["谁是entity的父亲的继承人？"]
["owner", "subsid"]	["entity的总裁子公司的名称是什么？"]
["身份", "event"]	["哪个文件","事件影响了entity所在的朝代的灭绝并在欧洲结束了第二次世界大战？"]
["主持", "origin"]	["entity的主持人的起源是什么？"]
["district", "southwest"]	["位于entity所在的区域西南的是什么？"]
["territory", "mammal"]	["entity覆盖的区域中濒临灭绝的哺乳动物是什么？"]
["spouse", "children"]	["entity的配偶孩子的名字是什么？"]
["deathPlace", "subdivisionName"]	["entity逝世的地方的细分名称是什么？"]
["producer", "relatives"]	["谁是entity的制片人的亲戚？"]
["knownFor", "type"]	["哪种类型是entity的成名作？"]
["所屬路線", "owner"]	["谁是entity的所属线路的所有者？"]
["occupation", "establishedEvent"]	["什么时候entity的职业创建既定事件？"]
["主演", "genre"]	["entity的演员属于哪种类型？"]
["代表作", "genre"]	["entity的代表作品属于哪种类型？"]
["namedAfter", "translitLang1Type"]	["什么是entity的名字的翻译方案？"]
["location", "region"]	["entity的位置属于哪个列表？","哪个列表包含entity的位置？"]
["namedAfter", "ethnicGroups"]	["entity的名字属于哪个民族？"]
["stadium", "callingCode"]	["什么是举办entity的体育场中的调用代码？"]
["namedAfter", "almaMater"]	["entity的名字从哪里毕业？"]
["location", "caption"]	["entity的位置的标识是什么？"]
["origin", "location"]	["entity的发源地在哪里？"]
["headquarters", "ethnicGroups"]	["entity的总部地址属于哪个民族？"]
["place", "timezoneDst"]	["entity的地址属于哪个时区？"]
["residence", "officialReligion"]	["哪一项是entity的居住地第一修正案的宗教条款中规定的受宪法保护的权利？"]
["builder", "founder"]	["谁是entity的建造商的创始人？","谁创立了entity的建造商？"]
["operatingSystem", "genre"]	["entity的操作系统属于哪种类型？"]
["discoverer", "manufacturer"]	["什么是entity的发现者的制造商？","谁制作了entity的发现者？"]
["platforms", "successor"]	["谁是entity的发布平台的继承人？"]
["state", "reptile"]	["什么是entity所在的州的官方国家爬行动物？"]
["state", "butterfly"]	["在entity所在的州中发现了什么样的蝴蝶？"]
["birthPlace", "caption"]	["entity的出生地的标识是什么？"]
["經紀公司", "location"]	["entity的经济公司在哪里？"]
["studio", "keyPeople"]	["谁是制作entity的工作室的首席执行官？"]
["state", "settlementType"]	["entity所在的州属于哪个地区？"]
["children", "predecessor"]	["谁是entity的子女的前身？"]
["incumbent", "successor"]	["谁是entity的现任的继承人？"]
["namedAfter", "children"]	["entity的名字孩子的名字是什么？"]
["showName", "starring"]	["谁主演entity的展示名？"]
["showName", "directedby"]	["谁导演entity的展示名？","谁是entity的展示名的导演？"]
["showName", "writtenby"]	["谁写过entity的展示名？","谁是entity的展示名的作者？"]
["演出", "spouse"]	["谁是出演entity的演员的配偶？"]
["cityofbirth", "leaderParty"]	["什么是entity的出生地的领导方？"]
["educate", "president"]	["谁是entity的总裁？"]
["discoverer", "deathPlace"]	["entity的发现者死在哪里？","entity的发现者的死亡地点是什么？"]
["namedAfter", "leaderName"]	["谁是entity的名字的领导者？"]
["headquarters", "subdivisionType"]	["entity的总部地址的行政级别是什么？"]
["stadium", "operator"]	["哪个公司举办entity的体育场属于？"]
["origin", "ethnicGroups"]	["entity的发源地属于哪个民族？"]
["family", "supportedPlatforms"]	["entity所属的家族支持哪些平台？"]
["after", "nationalteam"]	["哪支球队在20岁之前为entity的效力？"]
["title", "stadium"]	["entity的标题在哪里训练？"]
["after", "producer"]	["谁是entity的的制片人？"]
["producer", "before"]	["谁是entity的制片人的上一任？"]
["subdivisionName", "seallink"]	["什么是entity的密封链接？"]
["precededBy", "writer"]	["谁写过entity的一CLPM部作品？","谁是entity的一CLPM部作品的作者？"]
["subdivisionName", "butterfly"]	["在entity中发现了什么样的蝴蝶？"]
["operatingSystem", "developer"]	["谁开发entity的操作系统？","谁是entity的操作系统的开发者？"]
["distributor", "logo"]	["entity的发行商的标识是什么？"]
["popplace", "officialLanguages"]	["entity的主要分布区域的官方语言是什么？"]
["city", "religion"]	["entity的所在城市的宗教是什么？"]
["nextAlbum", "type"]	["哪种类型是entityLC之后的一CLPM部专辑？"]
["locationCountry", "legislature"]	["什么是entity所在的国家的立法机关？"]
["residence", "callingCode"]	["什么是entity的居住地中的调用代码？"]
["issue", "mother"]	["谁是entity的后裔的母亲？"]
["region", "regionalLanguages"]	["哪种语言是entity所在的行政区中的区域语言？"]
["region", "ethnicGroups"]	["entity所在的行政区属于哪个民族？"]
["region", "governmentType"]	["entity所在的行政区政府类型是什么？"]
["city", "callingCode"]	["什么是entity的所在城市中的调用代码？"]
["currentMembers", "family"]	["谁是entity的现任成员的家人？","谁是entity的现任成员的父亲？"]
["before", "placeOfBirth"]	["entity的前任出生在哪里？"]
["使用平臺", "sourceModel"]	["哪一个是entity的发布平台的源模型？"]
["writer", "spouse"]	["谁是entity的作者的配偶？"]
["birthPlace", "postalCodeType"]	["entity的出生地使用什么类型的邮政编码？"]
["popplace", "areaCodeType"]	["entity的主要分布区域有哪些类型的区号？"]
["subdivisionName", "lowerHouse"]	["什么是entity的下议院？"]
["langs", "sign"]	["entity擅长的语言使用什么样的语言？"]
["commonLanguages", "region"]	["entity的通用语言属于哪个列表？","哪个列表包含entity的通用语言？"]
["doctoralStudents", "doctoralStudents"]	["谁是entity的博士生的博士生？"]
["region", "legislature"]	["什么是entity所在的行政区的立法机关？"]
["主演", "label"]	["entity的演员的标签是什么？"]
["headquarters", "subdivisionName"]	["entity的总部地址的细分名称是什么？"]
["region", "leaderTitle"]	["entity所在的行政区在哪里作为leaderTitle？"]
["tenants", "chairman"]	["谁是entity的承租方的主席？"]
["owner", "list1."]	["谁是第一个在entity的总裁中添加内容的人？"]
["state", "demonym"]	["我们称之为entity所在的州的人是谁？"]
["precededBy", "label"]	["entity的一CLPM部作品的标签是什么？"]
["所在", "subdivisionType"]	["entity所在的城市的行政级别是什么？"]
["operatingSystem", "connectivity"]	["entity的操作系统的连接性是什么？"]
["placeOfBirth", "governor"]	["谁是entity的出生地的现任州长？"]
["leader", "mother"]	["谁是entity的领导人的母亲？"]
["areas", "callingCode"]	["什么是entity中的调用代码？"]
["usedBy", "titleLeader"]	["entity的使用者中领导者的头衔是什么？"]
["primaryUser", "callingCode"]	["什么是entity的主要用户中的调用代码？"]
["basinCountries", "legislature"]	["什么是entity的沿线国家的立法机关？"]
["city", "timezone"]	["entity的所在城市属于哪个时区？"]
["headquarters", "languages"]	["谁使用entity的总部地址的区域语言？"]
["spouse", "birthPlace"]	["entity的配偶出生在哪里？"]
["subdivisionName", "government"]	["entity所属政府形式是什么？"]
["notableCommanders", "birthPlace"]	["entity的著名指挥官出生在哪里？"]
["location", "translitLang1Type"]	["什么是entity的位置的翻译方案？"]
["headquarters", "demonym"]	["我们称之为entity的总部地址的人是谁？"]
["地址", "settlementType"]	["entity的地址属于哪个地区？"]
["cityofbirth", "southwest"]	["位于entity的出生地西南的是什么？"]
["birthplace", "establishedEvent"]	["什么时候entityO第一CLPM支登场的球队创建既定事件？"]
["inaugural", "birthPlace"]	["就职entity的政客出生在哪里？"]
["stylisticOrigins", "subdivisionType"]	["entity的风格源头的行政级别是什么？"]
["referee", "league"]	["哪个联盟entity的裁判员属于哪个？"]
["areaServed", "cities"]	["哪个列表按人口排列entity的服务区域中的城市地区？"]
["operator", "aircraftTransport"]	["什么是entity的相关运营A方是的飞机运输？"]
["birthplace", "p"]	["如何用汉语拼音拼写entityO第一CLPM支登场的球队？","entityO第一CLPM支登场的球队的中文拼音是什么？"]
["vicepresident", "birthPlace"]	["entity的副总统出生在哪里？"]
["associatedActs", "occupation"]	["entity的相关艺人从事的职业是什么？","entity的相关艺人的工作是什么？"]
["languages", "dialects"]	["entity使用的语言的方言是什么？"]
["stadium", "timezoneDst"]	["举办entity的体育场属于哪个时区？"]
["city", "upperHouse"]	["什么是entity的所在城市的上议院？"]
["before", "nationalteam"]	["哪支球队在20岁之前为entity的前任效力？"]
["title", "leader"]	["谁是entity的标题的领导者？"]
["placeOfDeath", "leaderName"]	["谁是entity的逝世地址的领导者？"]
["discoverySite", "seat"]	["发现entity的发现地区的地方是什么？"]
["唱片公司", "successor"]	["谁是entity与entity哪家唱片公司的继承人？"]
["discoverySite", "settlementType"]	["entity的发现地区属于哪个地区？"]
["discoverySite", "governor"]	["谁是entity的发现地区的现任州长？"]
["discoverySite", "tree"]	["什么树大部分种植在entity的发现地区？"]
["before", "father"]	["谁是entity的前任的父亲？"]
["state", "seatType"]	["entity所在的州的行政级别是什么？"]
["parent", "predecessor"]	["谁是entity的主公司的前身？"]
["series", "starring"]	["谁主演entity？"]
["developer", "owner"]	["谁是entity的开发商的所有者？"]
["series", "executiveProducer"]	["谁是entity的执行制片人？"]
["電視網", "keyPeople"]	["谁是播放entity的电视台的首席执行官？"]
["leader", "parents"]	["谁养育了entity的领导人？","谁把entity的领导人抚养长大？","谁是entity的领导人的父母？"]
["commander", "knownFor"]	["什么是entity的将领知道的？"]
["popplace", "legislature"]	["什么是entity的主要分布区域的立法机关？"]
["series", "producer"]	["谁是entity的制片人？"]
["episodeList", "directedby"]	["谁导演entity的节目列表？","谁是entity的节目列表的导演？"]
["locationCountry", "governmentType"]	["entity所在的国家政府类型是什么？"]
["before", "location"]	["entity的前任在哪里？"]
["combatant", "ideology"]	["什么是entity的政治意识形态？"]
["語言", "agency"]	["哪个机构entity使用的语言属于哪个？"]
["國家", "regionalLanguages"]	["哪种语言是entity所属的国家中的区域语言？"]
["ethnicity", "establishedEvent"]	["什么时候entity创建既定事件？"]
["prev", "writer"]	["谁写过entity的？","谁是entity的的作者？"]
["tenants", "coach"]	["谁是entity的承租方的现任经理？"]
["episodeList", "writtenby"]	["谁写过entity的节目列表？","谁是entity的节目列表的作者？"]
["placeOfDeath", "eventEnd"]	["什么时候entity的逝世地址解散了？"]
["官方語言", "region"]	["entity的官方语言属于哪个列表？","哪个列表包含entity的官方语言？"]
["precededBy", "location"]	["entity的一CLPM部作品在哪里？"]
["studio", "settlementType"]	["制作entity的工作室属于哪个地区？"]
["leader", "deathPlace"]	["entity的领导人死在哪里？","entity的领导人的死亡地点是什么？"]
["city", "populationBlank1Title"]	["什么是entity的所在城市？"]
["placeOfBirth", "grass"]	["什么样的草原产于entity的出生地？"]
["deathPlace", "populationBlank1Title"]	["什么是entity逝世的地方？"]
["platform", "supportedPlatforms"]	["entity的运行平台支持哪些平台？"]
["director", "spouse"]	["谁是entity的导演的配偶？"]
["commonLanguages", "dialects"]	["entity的通用语言的方言是什么？"]
["deathPlace", "caption"]	["entity逝世的地方的标识是什么？"]
["mother", "succession"]	["谁是entity的母亲的继承人？"]
["location", "title"]	["什么是entity的位置的名字？"]
["nationalteam", "lcb"]	["谁是entity的着名前球员？"]
["deathPlace", "label"]	["entity逝世的地方的标签是什么？"]
["placeOfDeath", "demonym"]	["我们称之为entity的逝世地址的人是谁？"]
["國家", "religion"]	["entity所属的国家的宗教是什么？"]
["region", "establishedTitle"]	["哪个法律","行为使entity所在的行政区成立？"]
["電視台", "iptvServ"]	["播放entity的电视台推广什么样的IPTV服务？"]
["seat", "manager"]	["谁是entity的行政中心的经理？"]
["stadium", "southeast"]	["哪个城市位于举办entity的体育场的东南部？"]
["starring", "religion"]	["参演entity的演员的宗教是什么？"]
["poleTeam", "engineeringHead"]	["谁是entity的优胜车队的工程负责人？"]
["commander", "successor"]	["谁是entity的将领的继承人？"]
["placeOfBirth", "motto"]	["什么是entity的出生地的座右铭？"]
["placeOfBirth", "label"]	["entity的出生地的标签是什么？"]
["birthplace", "postalCodeType"]	["entityO第一CLPM支登场的球队使用什么类型的邮政编码？"]
["before", "placeOfDeath"]	["entity的前任死在哪里？","这是entity的前任的死亡地点？"]
["nationality", "upperHouse"]	["什么是entity的国籍的上议院？"]
["director", "relatives"]	["谁是entity的导演的亲戚？"]
["builder", "services"]	["什么包含在entity的建造商的服务中？"]
["birthplace", "governmentType"]	["entityO第一CLPM支登场的球队政府类型是什么？"]
["nationality", "house"]	["entity的国籍有什么样的立法机构？"]
["moreUsers", "officialReligion"]	["哪一项是使用entity的国家第一修正案的宗教条款中规定的受宪法保护的权利？"]
["creator", "occupation"]	["entity的创造者从事的职业是什么？","entity的创造者的工作是什么？"]
["artist", "birthPlace"]	["发布entity的艺人出生在哪里？"]
["city", "southwest"]	["位于entity的所在城市西南的是什么？"]
["prev", "successor"]	["谁是entity的的继承人？"]
["origin", "fish"]	["什么是entity的发源地中的州鱼？"]
["製作", "subsid"]	["entity的制作方子公司的名称是什么？"]
["operator", "type"]	["哪种类型是entity的相关运营A方是？"]
["label", "keyPeople"]	["谁是entity的标签的首席执行官？"]
["placeOfBirth", "regionalLanguages"]	["哪种语言是entity的出生地中的区域语言？"]
["basinCountries", "leaderTitle"]	["entity的沿线国家在哪里作为leaderTitle？"]
["currentclub", "keyPeople"]	["谁是entity的首席执行官？"]
["author", "influenced"]	["谁影响了entity的原著作者？"]
["stadium", "governmentType"]	["举办entity的体育场政府类型是什么？"]
["stadium", "round"]	["什么是举办entity的体育场的主场？","哪一个是举办entity的体育场的主场？"]
["stadium", "motto"]	["什么是举办entity的体育场的座右铭？"]
["stadium", "northwest"]	["哪个地方位于举办entity的体育场的西北部？"]
["start", "operator"]	["哪个公司entity的起点站属于？"]
["location", "officialLanguages"]	["entity的位置的官方语言是什么？"]
["經紀公司", "industry"]	["entity的经济公司所属的产业类型是什么？"]
["builder", "industry"]	["entity的建造商所属的产业类型是什么？"]
["after", "father"]	["谁是entity的的父亲？"]
["演出", "ancestry"]	["出演entity的演员的家人来自哪里？","出演entity的演员的故乡是什么？"]
["builder", "keyPeople"]	["谁是entity的建造商的首席执行官？"]
["secondDriver", "title"]	["什么是entity的亚军车手的名字？"]
["workInstitutions", "caption"]	["entity的工作机构的标识是什么？"]
["album", "writer"]	["谁写过entity所属的音乐专辑？","谁是entity所属的音乐专辑的作者？"]
["commander", "issue"]	["谁是entity的将领的父母？"]
["電視台", "format"]	["播放entity的电视台的格式是什么？"]
["origin", "populationBlank1Title"]	["什么是entity的发源地？"]
["origin", "southeast"]	["哪个城市位于entity的发源地的东南部？"]
["birthPlace", "regionalLanguages"]	["哪种语言是entity的出生地中的区域语言？"]
["areaServed", "upperHouse"]	["什么是entity的服务区域的上议院？"]
["citizenship", "ethnicGroups"]	["entity的公民身份属于哪个民族？"]
["citizenship", "regionalLanguages"]	["哪种语言是entity的公民身份中的区域语言？"]
["nation", "leader"]	["谁是entity所属国家的领导者？"]
["influenced", "notableStudents"]	["谁是受到entity影响的人最着名的学生？"]
["placeOfBirth", "governmentType"]	["entity的出生地政府类型是什么？"]
["incumbent", "as"]	["entity的现任相当于什么？"]
["influences", "almaMater"]	["entity的人从哪里毕业？"]
["album", "producer"]	["谁是entity所属的音乐专辑的制片人？"]
["时代", "capital"]	["entity哪个时代的首都在哪里？"]
["spouse", "religion"]	["entity的配偶的宗教是什么？"]
["operator", "keyPeople"]	["谁是entity的相关运营A方是的首席执行官？"]
["start", "services"]	["什么包含在entity的起点站的服务中？"]
["label", "divisions"]	["哪个唱片公司的entity的标签拥有？"]
["頻道", "type"]	["哪种类型是放映entity的频道？"]
["operator", "list2."]	["谁是1904年entity的相关运营A方是最好的右手投手？"]
["placeOfBirth", "timezoneDst"]	["entity的出生地属于哪个时区？"]
["partof", "commander"]	["我们应该称之为entity的指挥官？"]
["主君", "children"]	["entity效力的君主孩子的名字是什么？"]
["birthPlace", "leader"]	["谁是entity的出生地的领导者？"]
["spouse", "deathPlace"]	["entity的配偶死在哪里？","entity的配偶的死亡地点是什么？"]
["city", "southeast"]	["哪个城市位于entity的所在城市的东南部？"]
["battles", "label"]	["entity参加的战争的标签是什么？"]
["city", "language"]	["entity的所在城市的语言是什么？"]
["combatant", "youthWing"]	["entity的青年翼是什么？"]
["areas", "lieutenantGovernor"]	["谁是entity现任副州长？"]
["leader", "almaMater"]	["entity的领导人从哪里毕业？"]
["spouse", "house"]	["entity的配偶有什么样的立法机构？"]
["afterElection", "birthPlace"]	["entity的胜选者出生在哪里？"]
["nationality", "languages"]	["谁使用entity的国籍的区域语言？"]
["after", "placeOfDeath"]	["entity的死在哪里？","这是entity的的死亡地点？"]
["owner", "founder"]	["谁是entity的总裁的创始人？","谁创立了entity的总裁？"]
["writer", "writer"]	["谁写过entity的作者？","谁是entity的作者的作者？"]
["owner", "leaderName"]	["谁是entity的总裁的领导者？"]
["areas", "southwest"]	["位于entity西南的是什么？"]
["areas", "dance"]	["entity的官方舞蹈是什么？"]
["areas", "reptile"]	["什么是entity的官方国家爬行动物？"]
["areas", "ethnicGroups"]	["entity属于哪个民族？"]
["lyrics", "birthPlace"]	["entity的出生在哪里？"]
["education", "president"]	["谁是entity的总裁？"]
["states", "label"]	["使用entity的地区的标签是什么？"]
["territory", "timezone1Dst"]	["entity覆盖的区域属于哪个时区？"]
["binomialAuthority", "placeOfBirth"]	["entity的二项式命名法学名的出生在哪里？"]
["after", "p"]	["如何用汉语拼音拼写entity的？","entity的的中文拼音是什么？"]
["areas", "officialLanguages"]	["entity的官方语言是什么？"]
["region", "subdivisionName"]	["entity所在的行政区的细分名称是什么？"]
["lyrics", "associatedActs"]	["谁与entity的相关联？"]
["county", "establishedEvent"]	["什么时候entity所属的省份创建既定事件？"]
["locationCity", "bird"]	["哪种鸟类生物居住在entity的所在地？"]
["代表作", "company"]	["哪个公司entity的代表作品属于？"]
["教育程度", "mammal"]	["entity的毕业学校中濒临灭绝的哺乳动物是什么？"]
["series", "company"]	["哪个公司entity属于？"]
["place", "translitLang1Type"]	["什么是entity的地址的翻译方案？"]
["occupation", "currency"]	["entity的职业的货币是什么？"]
["battles", "leaderTitle"]	["entity参加的战争在哪里作为leaderTitle？"]
["music", "notableInstruments"]	["哪种乐器entity的配乐作者发挥并因此而闻名？"]
["areas", "establishedTitle"]	["哪个法律","行为使entity成立？"]
["headquarters", "label"]	["entity的总部地址的标签是什么？"]
["country", "officialLanguages"]	["entity的的官方语言是什么？"]
["placeOfBirth", "leaderName"]	["谁是entity的出生地的领导者？"]
["owner", "location"]	["entity的总裁在哪里？"]
["programmingLanguage", "fam"]	["entity的开发语言属于哪种语言？"]
["stadium", "populationBlank1Title"]	["什么是举办entity的体育场？"]
["stadium", "caption"]	["举办entity的体育场的标识是什么？"]
["areas", "grass"]	["什么样的草原产于entity？"]
["territory", "caption"]	["entity覆盖的区域的标识是什么？"]
["owner", "logo"]	["entity的总裁的标识是什么？"]
["vicepresident", "predecessor"]	["谁是entity的副总统的前身？"]
["stadium", "postalCodeType"]	["举办entity的体育场使用什么类型的邮政编码？"]
["location", "governingBody"]	["entity的位置的管理机构是什么？"]
["capital", "north"]	["哪个城市位于entity的首都的北部？"]
["location", "officialReligion"]	["哪一项是entity的位置第一修正案的宗教条款中规定的受宪法保护的权利？"]
["territory", "regionalLanguages"]	["哪种语言是entity覆盖的区域中的区域语言？"]
["territory", "type"]	["哪种类型是entity覆盖的区域？"]
["residence", "ethnicGroups"]	["entity的居住地属于哪个民族？"]
["placeOfBirth", "officialLanguages"]	["entity的出生地的官方语言是什么？"]
["nominee", "title"]	["什么是entity的提名人的名字？"]
["headquarters", "governmentType"]	["entity的总部地址政府类型是什么？"]
["allegiance", "establishedEvent"]	["什么时候entity创建既定事件？"]
["managerclubs", "league"]	["哪个联盟entity执教的俱乐部属于哪个？"]
["platform", "developer"]	["谁开发entity的运行平台？","谁是entity的运行平台的开发者？"]
["artist", "parents"]	["谁养育了发布entity的艺人？","谁把发布entity的艺人抚养长大？","谁是发布entity的艺人的父母？"]
["nominee", "religion"]	["entity的提名人的宗教是什么？"]
["areas", "timezone"]	["entity属于哪个时区？"]
["areas", "bird"]	["哪种鸟类生物居住在entity？"]
["venue", "tenants"]	["哪个俱乐部entity的举办场地租给哪个？","哪个俱乐部做租客entity的举办场地？"]
["headquarters", "postalCodeType"]	["entity的总部地址使用什么类型的邮政编码？"]
["district", "subdivisionName"]	["entity所在的区域的细分名称是什么？"]
["studio", "spouse"]	["谁是制作entity的工作室的配偶？"]
["birthPlace", "insect"]	["什么样的昆虫是entity的出生地特有的？"]
["birthPlace", "reptile"]	["什么是entity的出生地的官方国家爬行动物？"]
["areas", "lowerHouse"]	["什么是entity的下议院？"]
["designer", "logo"]	["entity的设计者的标识是什么？"]
["binomialAuthority", "subdivisionType"]	["entity的二项式命名法学名的的行政级别是什么？"]
["origin", "officialLanguages"]	["entity的发源地的官方语言是什么？"]
["music", "subsid"]	["entity的配乐作者子公司的名称是什么？"]
["knownFor", "starring"]	["谁主演entity的成名作？"]
["state", "ethnicGroups"]	["entity所在的州属于哪个民族？"]
["garrison", "largestmetro"]	["entity驻守的区域最大的地铁在哪里？"]
["mother", "ethnicGroups"]	["entity的母亲属于哪个民族？"]
["spouse", "successor"]	["谁是entity的配偶的继承人？"]
["途径线路", "type"]	["哪种类型是entity沿途P经过什么线路？"]
["placeOfBirth", "postalCodeType"]	["entity的出生地使用什么类型的邮政编码？"]
["debutteam", "owner"]	["谁是entity的O第一CLPM支球队的所有者？"]
["city", "title"]	["什么是entity的所在城市的名字？"]
["publisher", "services"]	["什么包含在entity的出版商的服务中？"]
["album", "label"]	["entity所属的音乐专辑的标签是什么？"]
["manufacturer", "officialLanguages"]	["entity的生产商的官方语言是什么？"]
["manufacturer", "establishedEvent"]	["什么时候entity的生产商创建既定事件？"]
["areas", "food"]	["entity中食物的无生命徽章是什么？"]
["製作", "genre"]	["entity的制作方属于哪种类型？"]
["workplaces", "athletics"]	["entity的工作地点属于哪个协会？"]
["creator", "birthPlace"]	["entity的创造者出生在哪里？"]
["placeOfBirth", "upperHouse"]	["什么是entity的出生地的上议院？"]
["location", "northeast"]	["位于entity的位置东北的地方是什么？"]
["occupation", "type"]	["哪种类型是entity的职业？"]
["areas", "title"]	["什么是entity的名字？"]
["stadium", "ethnicGroups"]	["举办entity的体育场属于哪个民族？"]
["incumbent", "predecessor"]	["谁是entity的现任的前身？"]
["placeOfDeath", "tree"]	["什么树大部分种植在entity的逝世地址？"]
["city", "areaCodeType"]	["entity的所在城市有哪些类型的区号？"]
["city", "postalCodeType"]	["entity的所在城市使用什么类型的邮政编码？"]
["locationCity", "largestmetro"]	["entity的所在地最大的地铁在哪里？"]
["locationCity", "fish"]	["什么是entity的所在地中的州鱼？"]
["monarch", "father"]	["谁是entity的父亲？"]
["notableCommanders", "spouse"]	["谁是entity的著名指挥官的配偶？"]
["placeOfBirth", "timezone"]	["entity的出生地属于哪个时区？"]
["alliances", "event"]	["哪个文件","事件影响了entity的灭绝并在欧洲结束了第二次世界大战？"]
["after", "coach"]	["谁是entity的的现任经理？"]
["associatedActs", "title"]	["什么是entity的相关艺人的名字？"]
["location", "food"]	["entity的位置中食物的无生命徽章是什么？"]
["father", "placeOfBirth"]	["entity的父亲出生在哪里？"]
["headquarters", "regionalLanguages"]	["哪种语言是entity的总部地址中的区域语言？"]
["locale", "highestpoint"]	["entityEV的所属地点的最高点是什么？"]
["areas", "tree"]	["什么树大部分种植在entity？"]
["producer", "title"]	["什么是entity的制片人的名字？"]
["電視網", "iptvServ"]	["播放entity的电视台推广什么样的IPTV服务？"]
["出生地點", "p"]	["如何用汉语拼音拼写entity的出生地点？","entity的出生地点的中文拼音是什么？"]
["province", "seatType"]	["entity的行政级别是什么？"]
["province", "leaderParty"]	["什么是entity的领导方？"]
["province", "timezone"]	["entity属于哪个时区？"]
["house", "title"]	["什么是entity所属的王朝的名字？"]
["city", "timezoneDst"]	["entity的所在城市属于哪个时区？"]
["fam", "ancestor"]	["entity的的祖先在哪里？"]
["lyrics", "currentMembers"]	["谁是entity的的现任乐队领队？"]
["mother", "mother"]	["谁是entity的母亲的母亲？"]
["beforeElection", "office"]	["entity一CLPM任领导人的职务是什么？"]
["before", "governor"]	["谁是entity的前任的现任州长？"]
["music", "before"]	["谁是entity的配乐作者的上一任？"]
["starring", "candidate"]	["谁是参演entity的演员的候选人？"]
["教育程度", "chairman"]	["谁是entity的毕业学校的主席？"]
["deathPlace", "settlementType"]	["entity逝世的地方属于哪个地区？"]
["nation", "leaderTitle"]	["entity所属国家在哪里作为leaderTitle？"]
["nation", "leaderName"]	["谁是entity所属国家的领导者？"]
["birthplace", "currency"]	["entityO第一CLPM支登场的球队的货币是什么？"]
["deathplace", "leaderTitle"]	["entity逝世的地方在哪里作为leaderTitle？"]
["after", "list1."]	["谁是第一个在entity的中添加内容的人？"]
["before", "list1."]	["谁是第一个在entity的前任中添加内容的人？"]
["before", "manager"]	["谁是entity的前任的经理？"]
["before", "owner"]	["谁是entity的前任的所有者？"]
["before", "list3."]	["entity的前任为之奋斗的第三支职业球队是什么？"]
["after", "list3."]	["entity的为之奋斗的第三支职业球队是什么？"]
["nation", "establishedEvent"]	["什么时候entity所属国家创建既定事件？"]
["after", "list2."]	["谁是1904年entity的最好的右手投手？"]
["music", "title"]	["什么是entity的配乐作者的名字？"]
["主演", "influenced"]	["谁影响了entity的演员？"]
["director", "children"]	["entity的导演孩子的名字是什么？"]
["fam", "dialects"]	["entity的的方言是什么？"]
["allegiance", "as"]	["entity相当于什么？"]
["city", "north"]	["哪个城市位于entity的所在城市的北部？"]
["order", "isoCode"]	["什么是P由entity担任领导的机构的ISO代码？"]
["birthplace", "region"]	["entityO第一CLPM支登场的球队属于哪个列表？","哪个列表包含entityO第一CLPM支登场的球队？"]
["birthplace", "ethnicGroups"]	["entityO第一CLPM支登场的球队属于哪个民族？"]
["leaderName", "placeOfBirth"]	["entity的领导人出生在哪里？"]
["location", "areaCodeType"]	["entity的位置有哪些类型的区号？"]
["writer", "education"]	["entity的作者毕业的地方？","entity的作者从哪个学校毕业？"]
["educate", "mascot"]	["什么是entity的吉祥物？"]
["starring", "agency"]	["哪个机构参演entity的演员属于哪个？"]
["state", "subdivisionType"]	["entity所在的州的行政级别是什么？"]
["father", "author"]	["谁是entity的父亲的作者？"]
["state", "insect"]	["什么样的昆虫是entity所在的州特有的？"]
["president", "religion"]	["entity效力的总统的宗教是什么？"]
["writer", "relatives"]	["谁是entity的作者的亲戚？"]
["after", "candidate"]	["谁是entity的的候选人？"]
["时代", "titleLeader"]	["entity哪个时代中领导者的头衔是什么？"]
["stadium", "translitLang1Type"]	["什么是举办entity的体育场的翻译方案？"]
["president", "nationality"]	["entity效力的总统的国籍是什么？"]
["citizenship", "leaderTitle"]	["entity的公民身份在哪里作为leaderTitle？"]
["籍貫", "label"]	["entity的籍贯的标签是什么？"]
["leader", "party"]	["entity的领导人属于哪一方？"]
["children", "house"]	["entity的子女有什么样的立法机构？"]
["states", "languages"]	["谁使用使用entity的地区的区域语言？"]
["region", "postalCodeType"]	["entity所在的行政区使用什么类型的邮政编码？"]
["nation", "languages"]	["谁使用entity所属国家的区域语言？"]
["placeOfDeath", "governmentType"]	["entity的逝世地址政府类型是什么？"]
["政权", "religion"]	["entity的的宗教是什么？"]
["residence", "caption"]	["entity的居住地的标识是什么？"]
["nationality", "leader"]	["谁是entity的国籍的领导者？"]
["居住地", "upperHouse"]	["什么是entity的居住地的上议院？"]
["deathPlace", "northeast"]	["位于entity逝世的地方东北的地方是什么？"]
["writer", "nationality"]	["entity的作者的国籍是什么？"]
["籍貫", "subdivisionType"]	["entity的籍贯的行政级别是什么？"]
["region", "languages"]	["谁使用entity所在的行政区的区域语言？"]
["incumbent", "candidate"]	["谁是entity的现任的候选人？"]
["workInstitution", "before"]	["谁是entity的工作机构的上一任？"]
["children", "deputy"]	["谁是entity的子女的部长？"]
["title", "founder"]	["谁是entity的标题的创始人？","谁创立了entity的标题？"]
["leader", "placeOfDeath"]	["entity的领导人死在哪里？","这是entity的领导人的死亡地点？"]
["format", "owner"]	["谁是entity的节目形式的所有者？"]
["influenced", "region"]	["受到entity影响的人属于哪个列表？","哪个列表包含受到entity影响的人？"]
["nation", "ethnicGroups"]	["entity所属国家属于哪个民族？"]
["seat", "settlementType"]	["entity的行政中心属于哪个地区？"]
["placeOfDeath", "postalCodeType"]	["entity的逝世地址使用什么类型的邮政编码？"]
["commander", "placeOfBirth"]	["entity的将领出生在哪里？"]
["author", "subsid"]	["entity的原著作者子公司的名称是什么？"]
["genusAuthority", "almaMater"]	["entity的属PRU（生物PRU（）的命名者从哪里毕业？"]
["nation", "religion"]	["entity所属国家的宗教是什么？"]
["deathplace", "currency"]	["entity逝世的地方的货币是什么？"]
["territory", "upperHouse"]	["什么是entity覆盖的区域的上议院？"]
["country", "demonym"]	["我们称之为entity的的人是谁？"]
["combatant", "commander"]	["我们应该称之为entity的指挥官？"]
["lastAlbum", "language"]	["entity的一CLPM张专辑的语言是什么？"]
["owner", "southeast"]	["哪个城市位于entity的总裁的东南部？"]
["influenced", "deathPlace"]	["受到entity影响的人死在哪里？","受到entity影响的人的死亡地点是什么？"]
["before", "house"]	["entity的前任有什么样的立法机构？"]
["headquarters", "callingCode"]	["什么是entity的总部地址中的调用代码？"]
["cityofbirth", "title"]	["什么是entity的出生地的名字？"]
["city", "lieutenantGovernor"]	["谁是entity的所在城市现任副州长？"]
["workplaces", "nickname"]	["entity的工作地点的昵称是什么？"]
["issue", "as"]	["entity的后裔相当于什么？"]
["city", "governmentType"]	["entity的所在城市政府类型是什么？"]
["commander", "nationality"]	["entity的将领的国籍是什么？"]
["ground", "title"]	["什么是entity的地址的名字？"]
["manufacturer", "owner"]	["谁是entity的生产商的所有者？"]
["prev", "birthPlace"]	["entity的出生在哪里？"]
["combatant", "callingCode"]	["什么是entity中的调用代码？"]
["combatant", "leaderTitle"]	["entity在哪里作为leaderTitle？"]
["doctoralStudents", "influenced"]	["谁影响了entity的博士生？"]
["state", "label"]	["entity所在的州的标签是什么？"]
["city", "caption"]	["entity的所在城市的标识是什么？"]
["leader", "office"]	["entity的领导人的职务是什么？"]
["beforeElection", "alongside"]	["谁像entity一CLPM任领导人一样出名？","谁与entity一CLPM任领导人同样出名？"]
["successor", "honorificSuffix"]	["entity的一CLPM代产品的敬语后缀是什么？"]
["seat", "north"]	["哪个城市位于entity的行政中心的北部？"]
["seat", "subdivisionType"]	["entity的行政中心的行政级别是什么？"]
["所屬公司", "industry"]	["AentityEV的所属公司所属的产业类型是什么？"]
["father", "birthPlace"]	["entity的父亲出生在哪里？"]
["deathPlace", "fish"]	["什么是entity逝世的地方中的州鱼？"]
["spouse", "mother"]	["谁是entity的配偶的母亲？"]
["籍貫", "leaderName"]	["谁是entity的籍贯的领导者？"]
["primaryUser", "ethnicGroups"]	["entity的主要用户属于哪个民族？"]
["neighbor", "settlementType"]	["entity的邻近城市属于哪个地区？"]
["neighbor", "subdivisionName"]	["entity的邻近城市的细分名称是什么？"]
["演出", "label"]	["出演entity的演员的标签是什么？"]
["incumbent", "almaMater"]	["entity的现任从哪里毕业？"]
["deathPlace", "mayor"]	["谁是entity逝世的地方的市长？"]
["leaderParty", "predecessor"]	["谁是entity的的前身？"]
["parent", "type"]	["哪种类型是entity的主公司？"]
["creator", "influenced"]	["谁影响了entity的创造者？"]
["placeOfDeath", "timezone"]	["entity的逝世地址属于哪个时区？"]
["頻道", "subsid"]	["放映entity的频道子公司的名称是什么？"]
["label", "subdivisionType"]	["entity的标签的行政级别是什么？"]
["affiliation", "leaderTitle"]	["entity的隶属机构在哪里作为leaderTitle？"]
["next", "mother"]	["谁是entity的一CLPM届奖项的母亲？"]
["influences", "spouse"]	["谁是entity的人的配偶？"]
["capital", "region"]	["entity的首都属于哪个列表？","哪个列表包含entity的首都？"]
["nation", "event"]	["哪个文件","事件影响了entity所属国家的灭绝并在欧洲结束了第二次世界大战？"]
["appointer", "deputy"]	["谁是entity的任命者的部长？"]
["region", "timezoneDst"]	["entity所在的行政区属于哪个时区？"]
["birthPlace", "grass"]	["什么样的草原产于entity的出生地？"]
["parent", "services"]	["什么包含在entity的主公司的服务中？"]
["母校", "president"]	["谁是entity的母校的总裁？"]
["debutteam", "list2."]	["谁是1904年entity的O第一CLPM支球队最好的右手投手？"]
["allegiance", "officialReligion"]	["哪一项是entity第一修正案的宗教条款中规定的受宪法保护的权利？"]
["partof", "sign"]	["entity使用什么样的语言？"]
["location", "amphibian"]	["什么是IUCN脆弱的物种？青蛙？在entity的位置？"]
["countryofbirth", "event"]	["哪个文件","事件影响了entity的祖国的灭绝并在欧洲结束了第二次世界大战？"]
["cityofbirth", "northeast"]	["位于entity的出生地东北的地方是什么？"]
["city", "nickname"]	["entity的所在城市的昵称是什么？"]
["neighbors", "timezone"]	["entity的邻近区属于哪个时区？"]
["capital", "location"]	["entity的首都在哪里？"]
["locale", "governmentType"]	["entityEV的所属地点政府类型是什么？"]
["location", "leader"]	["谁是entity的位置的领导者？"]
["district", "southeast"]	["哪个城市位于entity所在的区域的东南部？"]
["influenced", "dialects"]	["受到entity影响的人的方言是什么？"]
["influenced", "influences"]	["谁影响受到entity影响的人？"]
["ethnicity", "leaderName"]	["谁是entity的领导者？"]
["代表作", "birthPlace"]	["entity的代表作品出生在哪里？"]
["deathPlace", "establishedTitle"]	["哪个法律","行为使entity逝世的地方成立？"]
["電視台", "industry"]	["播放entity的电视台所属的产业类型是什么？"]
["subdivisionName", "governor"]	["谁是entity的现任州长？"]
["usedBy", "languages"]	["谁使用entity的使用者的区域语言？"]
["usedBy", "house"]	["entity的使用者有什么样的立法机构？"]
["office", "event"]	["哪个文件","事件影响了entity担任的要职的灭绝并在欧洲结束了第二次世界大战？"]
["primeminister", "leader"]	["谁是entity的首相的领导者？"]
["league", "lcm"]	["谁是entity的新QPR英雄？"]
["league", "rcb"]	["谁是entity最强的玩家？"]
["partof", "religion"]	["entity的宗教是什么？"]
["cities", "subdivisionType"]	["entity的行政级别是什么？"]
["cityofbirth", "motto"]	["什么是entity的出生地的座右铭？"]
["director", "parents"]	["谁养育了entity的导演？","谁把entity的导演抚养长大？","谁是entity的导演的父母？"]
["music", "placeOfDeath"]	["entity的配乐作者死在哪里？","这是entity的配乐作者的死亡地点？"]
["notableCommanders", "honorificSuffix"]	["entity的著名指挥官的敬语后缀是什么？"]
["主君", "as"]	["entity效力的君主相当于什么？"]
["birthPlace", "northwest"]	["哪个地方位于entity的出生地的西北部？"]
["inaugural", "successor"]	["谁是就职entity的政客的继承人？"]
["subdivisionName", "mammal"]	["entity中濒临灭绝的哺乳动物是什么？"]
["seat", "timezone"]	["entity的行政中心属于哪个时区？"]
["capital", "settlementType"]	["entity的首都属于哪个地区？"]
["similar", "type"]	["哪种类型是P与entity相似的车型？"]
["occupation", "owner"]	["谁是entity的职业的所有者？"]
["office", "demonym"]	["我们称之为entity担任的要职的人是谁？"]
["before", "region"]	["entity的前任属于哪个列表？","哪个列表包含entity的前任？"]
["subdivisionName", "tartan"]	["什么是entity的官方苏格兰格子呢模式？"]
["主演", "placeOfBirth"]	["entity的演员出生在哪里？"]
["headquarters", "settlementType"]	["entity的总部地址属于哪个地区？"]
["state", "fish"]	["什么是entity所在的州中的州鱼？"]
["出生地", "timezoneDst"]	["entity的出生地属于哪个时区？"]
["演出", "genre"]	["出演entity的演员属于哪种类型？"]
["deputy", "office"]	["entity的代理人的职务是什么？"]
["cityofbirth", "populationBlank1Title"]	["什么是entity的出生地？"]
["managerclubs", "round"]	["什么是entity执教的俱乐部的主场？","哪一个是entity执教的俱乐部的主场？"]
["cityofbirth", "party"]	["entity的出生地属于哪一方？"]
["官方語言", "fam"]	["entity的官方语言属于哪种语言？"]
["電視台", "location"]	["播放entity的电视台在哪里？"]
["deathPlace", "currency"]	["entity逝世的地方的货币是什么？"]
["deathPlace", "capital"]	["entity逝世的地方的首都在哪里？"]
["publisher", "affiliations"]	["entity的出版商隶属于什么机构？"]
["國家首都名稱", "governingBody"]	["entity的首都的管理机构是什么？"]
["官方語言", "script"]	["什么是entity的官方语言的盲文？"]
["founder", "title"]	["什么是entity的创始人的名字？"]
["operator", "ground"]	["entity的相关运营A方是的主场在哪里？"]
["stadium", "label"]	["举办entity的体育场的标签是什么？"]
["tenants", "logo"]	["entity的承租方的标识是什么？"]
["plat", "predecessor"]	["谁是entity的发布平台的前身？"]
["主持", "spouse"]	["谁是entity的主持人的配偶？"]
["workInstitution", "chancellor"]	["谁是entity的工作机构的总理？"]
["workInstitution", "principal"]	["谁是entity的工作机构的负责人？"]
["leader", "honorificSuffix"]	["entity的领导人的敬语后缀是什么？"]
["政权", "capital"]	["entity的的首都在哪里？"]
["演出", "title"]	["什么是出演entity的演员的名字？"]
["citizenship", "officialReligion"]	["哪一项是entity的公民身份第一修正案的宗教条款中规定的受宪法保护的权利？"]
["title", "chairman"]	["谁是entity的标题的主席？"]
["出生地", "timezone"]	["entity的出生地属于哪个时区？"]
["製作", "location"]	["entity的制作方在哪里？"]
["langs", "child"]	["什么属于entity擅长的语言？"]
["states", "officialLanguages"]	["使用entity的地区的官方语言是什么？"]
["district", "timezone"]	["entity所在的区域属于哪个时区？"]
["office", "leaderTitle"]	["entity担任的要职在哪里作为leaderTitle？"]
["city", "soil"]	["entity的所在城市的州土壤是什么？"]
["title", "legislature"]	["什么是entity的标题的立法机关？"]
["plat", "manufacturer"]	["什么是entity的发布平台的制造商？","谁制作了entity的发布平台？"]
["連載雜誌", "language"]	["连载entity的杂志的语言是什么？"]
["nation", "upperHouse"]	["什么是entity所属国家的上议院？"]
["相關團體", "occupation"]	["entity的相关团体从事的职业是什么？","entity的相关团体的工作是什么？"]
["location", "fish"]	["什么是entity的位置中的州鱼？"]
["语言", "dialects"]	["entity所使用的语言的方言是什么？"]
["语言", "agency"]	["哪个机构entity所使用的语言属于哪个？"]
["政权", "currency"]	["entity的的货币是什么？"]
["city", "label"]	["entity的所在城市的标签是什么？"]
["next", "executiveProducer"]	["谁是entity的一CLPM届奖项的执行制片人？"]
["使用平台", "media"]	["什么是entity的使用平台的媒体？"]
["ground", "largestmetro"]	["entity的地址最大的地铁在哪里？"]
["ground", "grass"]	["什么样的草原产于entity的地址？"]
["ground", "upperhouse"]	["我们用什么名字来称呼entity的地址的上院？"]
["stadium", "type"]	["哪种类型是举办entity的体育场？"]
["place", "legislature"]	["什么是entity的地址的立法机关？"]
["stadium", "establishedEvent"]	["什么时候举办entity的体育场创建既定事件？"]
["教育程度", "label"]	["entity的毕业学校的标签是什么？"]
["nationality", "region"]	["entity的国籍属于哪个列表？","哪个列表包含entity的国籍？"]
["residence", "establishedEvent"]	["什么时候entity的居住地创建既定事件？"]
["president", "family"]	["谁是entity效力的总统的家人？","谁是entity效力的总统的父亲？"]
["電視台", "satServ"]	["什么是播放entity的电视台的母公司？"]
["线路", "operator"]	["哪个公司entity所属于的线路属于？"]
["usedBy", "callingCode"]	["什么是entity的使用者中的调用代码？"]
["region", "lowerHouse"]	["什么是entity所在的行政区的下议院？"]
["birthplace", "label"]	["entityO第一CLPM支登场的球队的标签是什么？"]
["starring", "origin"]	["参演entity的演员的起源是什么？"]
["headquarters", "founder"]	["谁是entity的总部地址的创始人？","谁创立了entity的总部地址？"]
["place", "ethnicGroups"]	["entity的地址属于哪个民族？"]
["電視台", "governmentType"]	["播放entity的电视台政府类型是什么？"]
["founder", "honorificPrefix"]	["entity的创始人的荣誉称号是什么？"]
["founder", "governor"]	["谁是entity的创始人的现任州长？"]
["leaderName", "honorificPrefix"]	["entity的领导人的荣誉称号是什么？"]
["seat", "timezoneDst"]	["entity的行政中心属于哪个时区？"]
["influenced", "influencedBy"]	["谁影响受到entity影响的人？"]
["birthplace", "bird"]	["哪种鸟类生物居住在entityO第一CLPM支登场的球队？"]
["secondDriver", "before"]	["谁是entity的亚军车手的上一任？"]
["residence", "tree"]	["什么树大部分种植在entity的居住地？"]
["influenced", "genre"]	["受到entity影响的人属于哪种类型？"]
["place", "upperHouse"]	["什么是entity的地址的上议院？"]
["state", "caption"]	["entity所在的州的标识是什么？"]
["subdivisionName", "governingBody"]	["entity的管理机构是什么？"]
["居住地", "label"]	["entity的居住地的标签是什么？"]
["languages", "sign"]	["entity使用的语言使用什么样的语言？"]
["title", "list3."]	["entity的标题为之奋斗的第三支职业球队是什么？"]
["influences", "label"]	["entity的人的标签是什么？"]
["所在", "timezone"]	["entity所在的城市属于哪个时区？"]
["manufacturer", "predecessor"]	["谁是entity的生产商的前身？"]
["placeOfBirth", "subdivisionType"]	["entity的出生地的行政级别是什么？"]
["followedBy", "producer"]	["谁是entity的一CLPM部作品的制片人？"]
["designer", "founder"]	["谁是entity的设计者的创始人？","谁创立了entity的设计者？"]
["designer", "industry"]	["entity的设计者所属的产业类型是什么？"]
["langs", "officialLanguages"]	["entity擅长的语言的官方语言是什么？"]
["locale", "leaderName"]	["谁是entityEV的所属地点的领导者？"]
["successor", "placeOfDeath"]	["entity的一CLPM代产品死在哪里？","这是entity的一CLPM代产品的死亡地点？"]
["電視台", "demonym"]	["我们称之为播放entity的电视台的人是谁？"]
["venue", "architect"]	["谁是entity的举办场地的建筑师？","谁建立了entity的举办场地？"]
["battles", "officialLanguages"]	["entity参加的战争的官方语言是什么？"]
["platforms", "influenced"]	["谁影响了entity的发布平台？"]
["vicepresident", "placeOfBirth"]	["entity的副总统出生在哪里？"]
["fam", "sign"]	["entity的使用什么样的语言？"]
["placeOfDeath", "settlementType"]	["entity的逝世地址属于哪个地区？"]
["途經地點", "affiliations"]	["entity的途径地点隶属于什么机构？"]
["writer", "birthPlace"]	["entity的作者出生在哪里？"]
["district", "governingBody"]	["entity所在的区域的管理机构是什么？"]
["religion", "language"]	["entity信仰的语言是什么？"]
["subdivisionName", "amphibian"]	["什么是IUCN脆弱的物种？青蛙？在entity？"]
["title", "deputy"]	["谁是entity的标题的部长？"]
["頻道", "founder"]	["谁是放映entity的频道的创始人？","谁创立了放映entity的频道？"]
["cityofbirth", "timezoneDst"]	["entity的出生地属于哪个时区？"]
["popplace", "tree"]	["什么树大部分种植在entity的主要分布区域？"]
["designer", "subsid"]	["entity的设计者子公司的名称是什么？"]
["stadium", "region"]	["举办entity的体育场属于哪个列表？","哪个列表包含举办entity的体育场？"]
["influences", "parents"]	["谁养育了entity的人？","谁把entity的人抚养长大？","谁是entity的人的父母？"]
["currentclub", "round"]	["什么是entity的主场？","哪一个是entity的主场？"]
["cityofbirth", "southeast"]	["哪个城市位于entity的出生地的东南部？"]
["owner", "chairman"]	["谁是entity的总裁的主席？"]
["associatedActs", "notableInstruments"]	["哪种乐器entity的相关艺人发挥并因此而闻名？"]
["cityofbirth", "label"]	["entity的出生地的标签是什么？"]
["birthplace", "tree"]	["什么树大部分种植在entityO第一CLPM支登场的球队？"]
["placeOfBirth", "capital"]	["entity的出生地的首都在哪里？"]
["commander", "alongside"]	["谁像entity的将领一样出名？","谁与entity的将领同样出名？"]
["similar", "predecessor"]	["谁是P与entity相似的车型的前身？"]
["leader", "primeminister"]	["谁是entity的领导人的首相？"]
["birthplace", "callingCode"]	["什么是entityO第一CLPM支登场的球队中的调用代码？"]
["頻道", "logo"]	["放映entity的频道的标识是什么？"]
["distributor", "predecessor"]	["谁是entity的发行商的前身？"]
["locale", "label"]	["entityEV的所属地点的标签是什么？"]
["country", "event"]	["哪个文件","事件影响了entity的的灭绝并在欧洲结束了第二次世界大战？"]
["cityofbirth", "settlementType"]	["entity的出生地属于哪个地区？"]
["出生地點", "soil"]	["entity的出生地点的州土壤是什么？"]
["currentclub", "industry"]	["entity所属的产业类型是什么？"]
["youthclubs", "rcb"]	["谁是entity所属青年俱乐部最强的玩家？"]
["cityofbirth", "governmentType"]	["entity的出生地政府类型是什么？"]
["fromAlbum", "label"]	["entity的一CLPM部专辑的标签是什么？"]
["managerclubs", "regionalName"]	["entity执教的俱乐部的地区名称是什么？"]
["studio", "divisions"]	["哪个唱片公司的制作entity的工作室拥有？"]
["father", "children"]	["entity的父亲孩子的名字是什么？"]
["nominee", "successor"]	["谁是entity的提名人的继承人？"]
["nominee", "president"]	["谁是entity的提名人的总裁？"]
["beforeElection", "almaMater"]	["entity一CLPM任领导人从哪里毕业？"]
["successor", "house"]	["entity的一CLPM代产品有什么样的立法机构？"]
["incumbent", "placeOfBirth"]	["entity的现任出生在哪里？"]
["countryofbirth", "currency"]	["entity的祖国的货币是什么？"]
["youthclubs", "nickname"]	["entity所属青年俱乐部的昵称是什么？"]
["最大城市名稱", "ethnicGroups"]	["entityA最大的城市属于哪个民族？"]
["origin", "largestmetro"]	["entity的发源地最大的地铁在哪里？"]
["origin", "title"]	["什么是entity的发源地的名字？"]
["influences", "placeOfBirth"]	["entity的人出生在哪里？"]
["cityofbirth", "seatType"]	["entity的出生地的行政级别是什么？"]
["cityofbirth", "seat"]	["发现entity的出生地的地方是什么？"]
["langs", "agency"]	["哪个机构entity擅长的语言属于哪个？"]
["areas", "largestmetro"]	["entity最大的地铁在哪里？"]
["演出", "parents"]	["谁养育了出演entity的演员？","谁把出演entity的演员抚养长大？","谁是出演entity的演员的父母？"]
["電視台", "language"]	["播放entity的电视台的语言是什么？"]
["birthplace", "subdivisionName"]	["entityO第一CLPM支登场的球队的细分名称是什么？"]
["所在地區", "candidate"]	["谁是entity的所属区域的候选人？"]
["currentclub", "lcb"]	["谁是entity的着名前球员？"]
["locale", "subdivisionType"]	["entityEV的所属地点的行政级别是什么？"]
["commander", "house"]	["entity的将领有什么样的立法机构？"]
["owner", "list2."]	["谁是1904年entity的总裁最好的右手投手？"]
["languages", "ancestor"]	["entity使用的语言的祖先在哪里？"]
["leader", "father"]	["谁是entity的领导人的父亲？"]
["capital", "governingBody"]	["entity的首都的管理机构是什么？"]
["居住地", "p"]	["如何用汉语拼音拼写entity的居住地？","entity的居住地的中文拼音是什么？"]
["afterElection", "title"]	["什么是entity的胜选者的名字？"]
["subdivisionName", "sign"]	["entity使用什么样的语言？"]
["province", "leaderName"]	["谁是entity的领导者？"]
["owner", "type"]	["哪种类型是entity的总裁？"]
["music", "parents"]	["谁养育了entity的配乐作者？","谁把entity的配乐作者抚养长大？","谁是entity的配乐作者的父母？"]
["archipelago", "timezone"]	["entity的属于哪个时区？"]
["locale", "officialLanguages"]	["entityEV的所属地点的官方语言是什么？"]
["creator", "before"]	["谁是entity的创造者的上一任？"]
["state", "dance"]	["entity所在的州的官方舞蹈是什么？"]
["origin", "governmentType"]	["entity的发源地政府类型是什么？"]
["所在地區", "settlementType"]	["entity的所属区域属于哪个地区？"]
["youthclubs", "stadium"]	["entity所属青年俱乐部在哪里训练？"]
["associatedActs", "origin"]	["entity的相关艺人的起源是什么？"]
["mother", "upperHouse"]	["什么是entity的母亲的上议院？"]
["commander", "currency"]	["entity的将领的货币是什么？"]
["lastAlbum", "format"]	["entity的一CLPM张专辑的格式是什么？"]
["city", "establishedTitle"]	["哪个法律","行为使entity的所在城市成立？"]
["subdivisionName", "establishedTitle"]	["哪个法律","行为使entity成立？"]
["state", "tree"]	["什么树大部分种植在entity所在的州？"]
["predecessor", "label"]	["entity的前代产品的标签是什么？"]
["commonLanguages", "agency"]	["哪个机构entity的通用语言属于哪个？"]
["after", "starring"]	["谁主演entity的？"]
["cityofbirth", "dialects"]	["entity的出生地的方言是什么？"]
["教育程度", "language"]	["entity的毕业学校的语言是什么？"]
["youthclubs", "club"]	["哪个俱乐部属于entity所属青年俱乐部？"]
["genre", "fam"]	["entity的类型属于哪种语言？"]
["出生地點", "timezone"]	["entity的出生地点属于哪个时区？"]
["cityofbirth", "timezone1Dst"]	["entity的出生地属于哪个时区？"]
["subdivisionName", "grass"]	["什么样的草原产于entity？"]
["currentclub", "northwest"]	["哪个地方位于entity的西北部？"]
["currentclub", "northeast"]	["位于entity东北的地方是什么？"]
["出生地點", "leaderTitle"]	["entity的出生地点在哪里作为leaderTitle？"]
["vicepresident", "almaMater"]	["entity的副总统从哪里毕业？"]
["subdivisionName", "group"]	["entity属于哪个组？"]
["cityofbirth", "location"]	["entity的出生地在哪里？"]
["place", "establishedEvent"]	["什么时候entity的地址创建既定事件？"]
["league", "chairman"]	["谁是entity的主席？"]
["district", "northeast"]	["位于entity所在的区域东北的地方是什么？"]
["products", "label"]	["entity的产品的标签是什么？"]
["channel", "industry"]	["entity的电视台所属的产业类型是什么？"]
["主唱", "spouse"]	["谁是entity的主唱的配偶？"]
["主唱", "placeOfBirth"]	["entity的主唱出生在哪里？"]
["capital", "seat"]	["发现entity的首都的地方是什么？"]
["教育程度", "ground"]	["entity的毕业学校的主场在哪里？"]
["province", "areaCodeType"]	["entity有哪些类型的区号？"]
["popplace", "religion"]	["entity的主要分布区域的宗教是什么？"]
["popplace", "callingCode"]	["什么是entity的主要分布区域中的调用代码？"]
["region", "religion"]	["entity所在的行政区的宗教是什么？"]
["nation", "governmentType"]	["entity所属国家政府类型是什么？"]
["designer", "spouse"]	["谁是entity的设计者的配偶？"]
["predecessor", "placeOfDeath"]	["entity的前代产品死在哪里？","这是entity的前代产品的死亡地点？"]
["cities", "settlementType"]	["entity属于哪个地区？"]
["所屬公司", "predecessorLine"]	["哪一行是AentityEV的所属公司的前身？"]
["president", "as"]	["entity效力的总统相当于什么？"]
["creator", "education"]	["entity的创造者毕业的地方？","entity的创造者从哪个学校毕业？"]
["deathPlace", "north"]	["哪个城市位于entity逝世的地方的北部？"]
["birthPlace", "soil"]	["entity的出生地的州土壤是什么？"]
["basinCountries", "regionalLanguages"]	["哪种语言是entity的沿线国家中的区域语言？"]
["label", "logo"]	["entity的标签的标识是什么？"]
["身份", "before"]	["谁是entity所在的朝代的上一任？"]
["state", "tartan"]	["什么是entity所在的州的官方苏格兰格子呢模式？"]
["consecratedBy", "bishop"]	["谁是entity的的主教？"]
["combatant", "timezoneDst"]	["entity属于哪个时区？"]
["issue", "religion"]	["entity的后裔的宗教是什么？"]
["creator", "almaMater"]	["entity的创造者从哪里毕业？"]
["office", "birthPlace"]	["entity担任的要职出生在哪里？"]
["cityofbirth", "caption"]	["entity的出生地的标识是什么？"]
["所屬公司", "services"]	["什么包含在AentityEV的所属公司的服务中？"]
["primeminister", "alongside"]	["谁像entity的首相一样出名？","谁与entity的首相同样出名？"]
["primeminister", "education"]	["entity的首相毕业的地方？","entity的首相从哪个学校毕业？"]
["affiliation", "affiliations"]	["entity的隶属机构隶属于什么机构？"]
["headquarters", "southeast"]	["哪个城市位于entity的总部地址的东南部？"]
["birthPlace", "event"]	["哪个文件","事件影响了entity的出生地的灭绝并在欧洲结束了第二次世界大战？"]
["areas", "upperhouse"]	["我们用什么名字来称呼entity的上院？"]
["artist", "magazine"]	["哪个杂志是发布entity的艺人发表在哪？"]
["next", "writer"]	["谁写过entity的一CLPM届奖项？","谁是entity的一CLPM届奖项的作者？"]
["father", "succession"]	["谁是entity的父亲的继承人？"]
["deputy", "honorificSuffix"]	["entity的代理人的敬语后缀是什么？"]
["office", "candidate"]	["谁是entity担任的要职的候选人？"]
["title", "predecessor"]	["谁是entity的标题的前身？"]
["birthPlace", "sovereigntyType"]	["什么是entity的出生地的主权类型？"]
["successor", "as"]	["entity的一CLPM代产品相当于什么？"]
["leader", "honorificPrefix"]	["entity的领导人的荣誉称号是什么？"]
["before", "almaMater"]	["entity的前任从哪里毕业？"]
["educate", "nickname"]	["entity的昵称是什么？"]
["educate", "athletics"]	["entity属于哪个协会？"]
["currentclub", "league"]	["哪个联盟entity属于哪个？"]
["before", "associatedActs"]	["谁与entity的前任相关联？"]
["頻道", "iptvServ"]	["放映entity的频道推广什么样的IPTV服务？"]
["district", "leaderParty"]	["什么是entity所在的区域的领导方？"]
["city", "seat"]	["发现entity的所在城市的地方是什么？"]
["before", "honorificPrefix"]	["entity的前任的荣誉称号是什么？"]
["相關團體", "magazine"]	["哪个杂志是entity的相关团体发表在哪？"]
["headquarters", "timezoneDst"]	["entity的总部地址属于哪个时区？"]
["platform", "media"]	["什么是entity的运行平台的媒体？"]
["platform", "predecessor"]	["谁是entity的运行平台的前身？"]
["referee", "before"]	["谁是entity的裁判员的上一任？"]
["primeminister", "placeOfBirth"]	["entity的首相出生在哪里？"]
["areas", "subdivisionType"]	["entity的行政级别是什么？"]
["studio", "location"]	["制作entity的工作室在哪里？"]
["moreUsers", "aircraftTransport"]	["什么是使用entity的国家的飞机运输？"]
["state", "seallink"]	["什么是entity所在的州的密封链接？"]
["moreUsers", "caption"]	["使用entity的国家的标识是什么？"]
["alongside", "candidate"]	["谁是P与entityA同时在任的政客的候选人？"]
["consecratedBy", "honorificSuffix"]	["entity的的敬语后缀是什么？"]
["state", "grass"]	["什么样的草原产于entity所在的州？"]
["workplaces", "provost"]	["谁是entity的工作地点的教务长？"]
["predecessor", "governor"]	["谁是entity的前代产品的现任州长？"]
["title", "youthWing"]	["entity的标题的青年翼是什么？"]
["ground", "settlementType"]	["entity的地址属于哪个地区？"]
["經紀公司", "satServ"]	["什么是entity的经济公司的母公司？"]
["alongside", "almaMater"]	["P与entityA同时在任的政客从哪里毕业？"]
["league", "logo"]	["entity的标识是什么？"]
["district", "settlementType"]	["entity所在的区域属于哪个地区？"]
["allegiance", "demonym"]	["我们称之为entity的人是谁？"]
["allegiance", "leaderName"]	["谁是entity的领导者？"]
["title", "affiliations"]	["entity的标题隶属于什么机构？"]
["influenced", "developer"]	["谁开发受到entity影响的人？","谁是受到entity影响的人的开发者？"]
["title", "executiveProducer"]	["谁是entity的标题的执行制片人？"]
["genre", "influenced"]	["谁影响了entity的类型？"]
["subdivisionName", "currency"]	["entity的货币是什么？"]
["residence", "subdivisionType"]	["entity的居住地的行政级别是什么？"]
["areas", "mammal"]	["entity中濒临灭绝的哺乳动物是什么？"]
["company", "keyPeople"]	["谁是entity的运营公司的首席执行官？"]
["locationCountry", "officialReligion"]	["哪一项是entity所在的国家第一修正案的宗教条款中规定的受宪法保护的权利？"]
["studio", "cableServ"]	["哪个公司制作entity的工作室属于？"]
["areas", "legislature"]	["什么是entity的立法机关？"]
["place", "southeast"]	["哪个城市位于entity的地址的东南部？"]
["停靠", "operator"]	["哪个公司entity属于？"]
["notableCommanders", "almaMater"]	["entity的著名指挥官从哪里毕业？"]
["主君", "spouse"]	["谁是entity效力的君主的配偶？"]
["region", "dialects"]	["entity所在的行政区的方言是什么？"]
["时代", "southeast"]	["哪个城市位于entity哪个时代的东南部？"]
["workInstitutions", "logo"]	["entity的工作机构的标识是什么？"]
["studio", "iptvServ"]	["制作entity的工作室推广什么样的IPTV服务？"]
["occupation", "leaderTitle"]	["entity的职业在哪里作为leaderTitle？"]
["influenced", "knownFor"]	["什么是受到entity影响的人知道的？"]
["party", "leaderName"]	["谁是entity所属的党派的领导者？"]
["venue", "location"]	["entity的举办场地在哪里？"]
["family", "family"]	["谁是entity所属的家族的家人？","谁是entity所属的家族的父亲？"]
["种族", "languages"]	["谁使用entity的种族的区域语言？"]
["after", "placeOfBirth"]	["entity的出生在哪里？"]
["residence", "governingBody"]	["entity的居住地的管理机构是什么？"]
["director", "birthPlace"]	["entity的导演出生在哪里？"]
["現任成員", "currentMembers"]	["谁是entity的现任成员的现任乐队领队？"]
["starring", "executiveProducer"]	["谁是参演entity的演员的执行制片人？"]
["label", "origin"]	["entity的标签的起源是什么？"]
["province", "p"]	["如何用汉语拼音拼写entity？","entity的中文拼音是什么？"]
["music", "religion"]	["entity的配乐作者的宗教是什么？"]
["deathPlace", "timezoneDst"]	["entity逝世的地方属于哪个时区？"]
["placeOfDeath", "currency"]	["entity的逝世地址的货币是什么？"]
["city", "governingBody"]	["entity的所在城市的管理机构是什么？"]
["birthPlace", "officialLanguages"]	["entity的出生地的官方语言是什么？"]
["place", "areaCodeType"]	["entity的地址有哪些类型的区号？"]
["place", "reptile"]	["什么是entity的地址的官方国家爬行动物？"]
["place", "amphibian"]	["什么是IUCN脆弱的物种？青蛙？在entity的地址？"]
["monarch", "religion"]	["entity的宗教是什么？"]
["birthPlace", "upperHouse"]	["什么是entity的出生地的上议院？"]
["after", "founder"]	["谁是entity的的创始人？","谁创立了entity的？"]
["nationalteam", "establishedEvent"]	["什么时候entity创建既定事件？"]
["state", "upperhouse"]	["我们用什么名字来称呼entity所在的州的上院？"]
["genusAuthority", "notableStudents"]	["谁是entity的属PRU（生物PRU（）的命名者最着名的学生？"]
["platforms", "type"]	["哪种类型是entity的发布平台？"]
["播放地區", "postalCodeType"]	["entity使用什么类型的邮政编码？"]
["distributor", "satServ"]	["什么是entity的发行商的母公司？"]
["經紀公司", "iptvServ"]	["entity的经济公司推广什么样的IPTV服务？"]
["occupation", "founder"]	["谁是entity的职业的创始人？","谁创立了entity的职业？"]
["after", "associatedActs"]	["谁与entity的相关联？"]
["author", "title"]	["什么是entity的原著作者的名字？"]
["artist", "education"]	["发布entity的艺人毕业的地方？","发布entity的艺人从哪个学校毕业？"]
["occupation", "location"]	["entity的职业在哪里？"]
["beforeElection", "children"]	["entity一CLPM任领导人孩子的名字是什么？"]
["locationCity", "establishedTitle"]	["哪个法律","行为使entity的所在地成立？"]
["series", "voices"]	["谁是entity中的配音演员？"]
["mother", "before"]	["谁是entity的母亲的上一任？"]
["alongside", "before"]	["谁是P与entityA同时在任的政客的上一任？"]
["occupation", "leader"]	["谁是entity的职业的领导者？"]
["primeminister", "as"]	["entity的首相相当于什么？"]
["leader", "nationality"]	["entity的领导人的国籍是什么？"]
["locationCountry", "callingCode"]	["什么是entity所在的国家中的调用代码？"]
["artist", "spouse"]	["谁是发布entity的艺人的配偶？"]
["birthPlace", "officialReligion"]	["哪一项是entity的出生地第一修正案的宗教条款中规定的受宪法保护的权利？"]
["place", "insect"]	["什么样的昆虫是entity的地址特有的？"]
["referee", "placeOfBirth"]	["entity的裁判员出生在哪里？"]
["placeOfBirth", "settlementType"]	["entity的出生地属于哪个地区？"]
["stadium", "areaCodeType"]	["举办entity的体育场有哪些类型的区号？"]
["artist", "honorificSuffix"]	["发布entity的艺人的敬语后缀是什么？"]
["電視網", "industry"]	["播放entity的电视台所属的产业类型是什么？"]
["播放地區", "governmentType"]	["entity政府类型是什么？"]
["代表作", "developer"]	["谁开发entity的代表作品？","谁是entity的代表作品的开发者？"]
["music", "writer"]	["谁写过entity的配乐作者？","谁是entity的配乐作者的作者？"]
["使用平台", "supportedPlatforms"]	["entity的使用平台支持哪些平台？"]
["champion", "affiliation"]	["谁隶属于entity的总冠军？"]
["lyrics", "occupation"]	["entity的从事的职业是什么？","entity的的工作是什么？"]
["title", "house"]	["entity的标题有什么样的立法机构？"]
["states", "largestmetro"]	["使用entity的地区最大的地铁在哪里？"]
["states", "soil"]	["使用entity的地区的州土壤是什么？"]
["president", "parents"]	["谁养育了entity效力的总统？","谁把entity效力的总统抚养长大？","谁是entity效力的总统的父母？"]
["state", "motto"]	["什么是entity所在的州的座右铭？"]
["genre", "supportedPlatforms"]	["entity的类型支持哪些平台？"]
["usedBy", "aircraftTransport"]	["什么是entity的使用者的飞机运输？"]
["alongside", "successor"]	["谁是P与entityA同时在任的政客的继承人？"]
["author", "services"]	["什么包含在entity的原著作者的服务中？"]
["alongside", "birthPlace"]	["P与entityA同时在任的政客出生在哪里？"]
["origin", "insect"]	["什么样的昆虫是entity的发源地特有的？"]
["alongside", "governor"]	["谁是P与entityA同时在任的政客的现任州长？"]
["workplaces", "type"]	["哪种类型是entity的工作地点？"]
["areas", "lowerhouse"]	["我们用什么名字打电话给entity的下院？"]
["location", "mayor"]	["谁是entity的位置的市长？"]
["before", "notableStudents"]	["谁是entity的前任最着名的学生？"]
["monarch", "succession"]	["谁是entity的继承人？"]
["state", "lowerhouse"]	["我们用什么名字打电话给entity所在的州的下院？"]
["managerclubs", "homeStadium"]	["什么是entity执教的俱乐部的主场？"]
["precededBy", "updatemodel"]	["entity的一CLPM部作品更新模型的名称是什么？"]
["locationCity", "nickname"]	["entity的所在地的昵称是什么？"]
["電視台", "subsid"]	["播放entity的电视台子公司的名称是什么？"]
["founder", "leaderName"]	["谁是entity的创始人的领导者？"]
["fam", "children"]	["entity的孩子的名字是什么？"]
["beforeElection", "deputy"]	["谁是entity一CLPM任领导人的部长？"]
["genre", "dialects"]	["entity的类型的方言是什么？"]
["areas", "areaCodeType"]	["entity有哪些类型的区号？"]
["所在", "ethnicGroups"]	["entity所在的城市属于哪个民族？"]
["spouse", "party"]	["entity的配偶属于哪一方？"]
["主君", "before"]	["谁是entity效力的君主的上一任？"]
["awards", "caption"]	["entity获得的奖项的标识是什么？"]
["series", "manufacturer"]	["什么是entity的制造商？","谁制作了entity？"]
["residence", "subdivisionName"]	["entity的居住地的细分名称是什么？"]
["company", "subsid"]	["entity的运营公司子公司的名称是什么？"]
["company", "divisions"]	["哪个唱片公司的entity的运营公司拥有？"]
["episodeList", "title"]	["什么是entity的节目列表的名字？"]
["placeOfBirth", "fish"]	["什么是entity的出生地中的州鱼？"]
["associatedActs", "before"]	["谁是entity的相关艺人的上一任？"]
["before", "connectivity"]	["entity的前任的连接性是什么？"]
["countryAdminDivisions", "subdivisionName"]	["entity的细分名称是什么？"]
["subdivisionName", "insect"]	["什么样的昆虫是entity特有的？"]
["locale", "p"]	["如何用汉语拼音拼写entityEV的所属地点？","entityEV的所属地点的中文拼音是什么？"]
["influencedBy", "placeOfBirth"]	["P对entity产生影响的编码语言出生在哪里？"]
["studio", "sisterNames"]	["什么是制作entity的工作室的姐妹名字？"]
["province", "label"]	["entity的标签是什么？"]
["winners", "coach"]	["谁是entity的冠军队伍的现任经理？"]
["winners", "ground"]	["entity的冠军队伍的主场在哪里？"]
["commander", "primeminister"]	["谁是entity的将领的首相？"]
["genre", "establishedEvent"]	["什么时候entity的类型创建既定事件？"]
["locationCity", "p"]	["如何用汉语拼音拼写entity的所在地？","entity的所在地的中文拼音是什么？"]
["nation", "currency"]	["entity所属国家的货币是什么？"]
["place", "officialLanguages"]	["entity的地址的官方语言是什么？"]
["author", "athletics"]	["entity的原著作者属于哪个协会？"]
["author", "logo"]	["entity的原著作者的标识是什么？"]
["areas", "fish"]	["什么是entity中的州鱼？"]
["designer", "birthPlace"]	["entity的设计者出生在哪里？"]
["教育程度", "affiliation"]	["谁隶属于entity的毕业学校？"]
["doctoralAdvisor", "placeOfBirth"]	["entity的博士生导师出生在哪里？"]
["afterElection", "spouse"]	["谁是entity的胜选者的配偶？"]
["subdivisionName", "leader"]	["谁是entity的领导者？"]
["birthPlace", "region"]	["entity的出生地属于哪个列表？","哪个列表包含entity的出生地？"]
["platform", "connectivity"]	["entity的运行平台的连接性是什么？"]
["district", "capital"]	["entity所在的区域的首都在哪里？"]
["primeminister", "primeminister"]	["谁是entity的首相的首相？"]
["place", "caption"]	["entity的地址的标识是什么？"]
["territory", "tree"]	["什么树大部分种植在entity覆盖的区域？"]
["途径线路", "operator"]	["哪个公司entity沿途P经过什么线路属于？"]
["province", "subdivisionName"]	["entity的细分名称是什么？"]
["territory", "motto"]	["什么是entity覆盖的区域的座右铭？"]
["所在", "leaderTitle"]	["entity所在的城市在哪里作为leaderTitle？"]
["headquarters", "legislature"]	["什么是entity的总部地址的立法机关？"]
["title", "commander"]	["我们应该称之为entity的标题的指挥官？"]
["starring", "nationality"]	["参演entity的演员的国籍是什么？"]
["subdivisionName", "populationBlank1Title"]	["什么是entity？"]
["subdivisionName", "demographics1Name"]	["entity的人口统计名称是什么？"]
["subdivisionName", "autonomousCommunity"]	["什么是entity的自治社区？"]
["subdivisionName", "president"]	["谁是entity的总裁？"]
["subdivisionName", "language"]	["entity的语言是什么？"]
["district", "postalCodeType"]	["entity所在的区域使用什么类型的邮政编码？"]
["subdivisionName", "upperhouse"]	["我们用什么名字来称呼entity的上院？"]
["subdivisionName", "food"]	["entity中食物的无生命徽章是什么？"]
["author", "deathPlace"]	["entity的原著作者死在哪里？","entity的原著作者的死亡地点是什么？"]
["namedAfter", "leader"]	["谁是entity的名字的领导者？"]
["branch", "caption"]	["entity的的标识是什么？"]
["主君", "predecessor"]	["谁是entity效力的君主的前身？"]
["countryAdminDivisions", "settlementType"]	["entity属于哪个地区？"]
["經紀公司", "establishedEvent"]	["什么时候entity的经济公司创建既定事件？"]
["showName", "producer"]	["谁是entity的展示名的制片人？"]
["influencedBy", "developer"]	["谁开发P对entity产生影响的编码语言？","谁是P对entity产生影响的编码语言的开发者？"]
["經紀公司", "divisions"]	["哪个唱片公司的entity的经济公司拥有？"]
["venue", "before"]	["谁是entity的举办场地的上一任？"]
["countryAdminDivisions", "timezone"]	["entity属于哪个时区？"]
["youthclubs", "lcm"]	["谁是entity所属青年俱乐部的新QPR英雄？"]
["出生地點", "settlementType"]	["entity的出生地点属于哪个地区？"]
["party", "commander"]	["我们应该称之为entity所属的党派的指挥官？"]
["series", "type"]	["哪种类型是entity？"]
["locationCity", "lowerhouse"]	["我们用什么名字打电话给entity的所在地的下院？"]
["namedAfter", "title"]	["什么是entity的名字的名字？"]
["manufacturer", "caption"]	["entity的生产商的标识是什么？"]
["starring", "honorificSuffix"]	["参演entity的演员的敬语后缀是什么？"]
["designer", "location"]	["entity的设计者在哪里？"]
["author", "party"]	["entity的原著作者属于哪一方？"]
["stadium", "mayor"]	["谁是举办entity的体育场的市长？"]
["city", "establishedEvent"]	["什么时候entity的所在城市创建既定事件？"]
["namedAfter", "birthPlace"]	["entity的名字出生在哪里？"]
["placeOfBirth", "languages"]	["谁使用entity的出生地的区域语言？"]
["operator", "location"]	["entity的相关运营A方是在哪里？"]
["company", "satServ"]	["什么是entity的运营公司的母公司？"]
["locale", "subdivisionName"]	["entityEV的所属地点的细分名称是什么？"]
["placeOfBirth", "logo"]	["entity的出生地的标识是什么？"]
["workInstitutions", "nickname"]	["entity的工作机构的昵称是什么？"]
["countryAdminDivisions", "ethnicGroups"]	["entity属于哪个民族？"]
["公路名稱", "cities"]	["哪个列表按人口排列entity所在的公路名称中的城市地区？"]
["after", "deathPlace"]	["entity的死在哪里？","entity的的死亡地点是什么？"]
["身份", "translitLang1Type"]	["什么是entity所在的朝代的翻译方案？"]
["format", "producer"]	["谁是entity的节目形式的制片人？"]
["locationCountry", "demonym"]	["我们称之为entity所在的国家的人是谁？"]
["deathplace", "ethnicGroups"]	["entity逝世的地方属于哪个民族？"]
["電視網", "sisterNames"]	["什么是播放entity的电视台的姐妹名字？"]
["nationality", "caption"]	["entity的国籍的标识是什么？"]
["artist", "starring"]	["谁主演发布entity的艺人？"]
["演出", "origin"]	["出演entity的演员的起源是什么？"]
["youthclubs", "type"]	["哪种类型是entity所属青年俱乐部？"]
["langs", "founder"]	["谁是entity擅长的语言的创始人？","谁创立了entity擅长的语言？"]
["areaServed", "timezone"]	["entity的服务区域属于哪个时区？"]
["next", "successor"]	["谁是entity的一CLPM届奖项的继承人？"]
["territory", "seat"]	["发现entity覆盖的区域的地方是什么？"]
["platform", "company"]	["哪个公司entity的运行平台属于？"]
["starring", "placeOfDeath"]	["参演entity的演员死在哪里？","这是参演entity的演员的死亡地点？"]
["動畫製作", "location"]	["entity的动画在哪里？"]
["occupation", "subsid"]	["entity的职业子公司的名称是什么？"]
["youthclubs", "coach"]	["谁是entity所属青年俱乐部的现任经理？"]
["studio", "callingCode"]	["什么是制作entity的工作室中的调用代码？"]
["knownFor", "children"]	["entity的成名作孩子的名字是什么？"]
["居住地", "postalCodeType"]	["entity的居住地使用什么类型的邮政编码？"]
["母校", "logo"]	["entity的母校的标识是什么？"]
["教育程度", "caption"]	["entity的毕业学校的标识是什么？"]
["居住地", "governmentType"]	["entity的居住地政府类型是什么？"]
["occupation", "governmentType"]	["entity的职业政府类型是什么？"]
["territory", "label"]	["entity覆盖的区域的标签是什么？"]
["father", "house"]	["entity的父亲有什么样的立法机构？"]
["channel", "owner"]	["谁是entity的电视台的所有者？"]
["distributor", "sisterNames"]	["什么是entity的发行商的姐妹名字？"]
["region", "areaCodeType"]	["entity所在的行政区有哪些类型的区号？"]
["使用平台", "logo"]	["entity的使用平台的标识是什么？"]
["locale", "legislature"]	["什么是entityEV的所属地点的立法机关？"]
["successor", "relatives"]	["谁是entity的一CLPM代产品的亲戚？"]
["popplace", "leaderTitle"]	["entity的主要分布区域在哪里作为leaderTitle？"]
["popplace", "location"]	["entity的主要分布区域在哪里？"]
["播放地區", "upperHouse"]	["什么是entity的上议院？"]
["writer", "almaMater"]	["entity的作者从哪里毕业？"]
["popplace", "highestpoint"]	["entity的主要分布区域的最高点是什么？"]
["tenants", "club"]	["哪个俱乐部属于entity的承租方？"]
["所屬部門", "north"]	["哪个城市位于entityEV的所属部门的北部？"]
["label", "leaderName"]	["谁是entity的标签的领导者？"]
["residence", "areaCodeType"]	["entity的居住地有哪些类型的区号？"]
["電視網", "subsid"]	["播放entity的电视台子公司的名称是什么？"]
["citizenship", "deputy"]	["谁是entity的公民身份的部长？"]
["builder", "father"]	["谁是entity的建造商的父亲？"]
["身份", "leader"]	["谁是entity所在的朝代的领导者？"]
["before", "knownFor"]	["什么是entity的前任知道的？"]
["products", "connectivity"]	["entity的产品的连接性是什么？"]
["地址", "timezone"]	["entity的地址属于哪个时区？"]
["president", "deputy"]	["谁是entity效力的总统的部长？"]
["place", "demonym"]	["我们称之为entity的地址的人是谁？"]
["predecessor", "deathPlace"]	["entity的前代产品死在哪里？","entity的前代产品的死亡地点是什么？"]
["areaServed", "subdivisionType"]	["entity的服务区域的行政级别是什么？"]
["director", "nationality"]	["entity的导演的国籍是什么？"]
["areaServed", "governmentType"]	["entity的服务区域政府类型是什么？"]
["place", "title"]	["什么是entity的地址的名字？"]
["office", "seatType"]	["entity担任的要职的行政级别是什么？"]
["venue", "operator"]	["哪个公司entity的举办场地属于？"]
["locale", "regionalLanguages"]	["哪种语言是entityEV的所属地点中的区域语言？"]
["office", "postalCodeType"]	["entity担任的要职使用什么类型的邮政编码？"]
["經紀公司", "founder"]	["谁是entity的经济公司的创始人？","谁创立了entity的经济公司？"]
["國家", "officialReligion"]	["哪一项是entity所属的国家第一修正案的宗教条款中规定的受宪法保护的权利？"]
["doctoralAdvisor", "title"]	["什么是entity的博士生导师的名字？"]
["territory", "fish"]	["什么是entity覆盖的区域中的州鱼？"]
["region", "type"]	["哪种类型是entity所在的行政区？"]
["genre", "influencedBy"]	["谁影响entity的类型？"]
["origin", "demonym"]	["我们称之为entity的发源地的人是谁？"]
["company", "iptvServ"]	["entity的运营公司推广什么样的IPTV服务？"]
["areaServed", "legislature"]	["什么是entity的服务区域的立法机关？"]
["mostSuccessfulClub", "title"]	["什么是entity的生涯LC里A最成功的俱乐部的名字？"]
["capital", "leaderName"]	["谁是entity的首都的领导者？"]
["官方文字", "fam"]	["entity的官方语言属于哪种语言？"]
["國家首都名稱", "region"]	["entity的首都属于哪个列表？","哪个列表包含entity的首都？"]
["states", "cities"]	["哪个列表按人口排列使用entity的地区中的城市地区？"]
["nation", "callingCode"]	["什么是entity所属国家中的调用代码？"]
["children", "fam"]	["entity的子女属于哪种语言？"]
["leaderName", "title"]	["什么是entity的领导人的名字？"]
["basinCountries", "callingCode"]	["什么是entity的沿线国家中的调用代码？"]
["cities", "caption"]	["entity的标识是什么？"]
["cities", "leaderTitle"]	["entity在哪里作为leaderTitle？"]
["nominee", "before"]	["谁是entity的提名人的上一任？"]
["senators", "title"]	["什么是entity的参议员的名字？"]
["before", "leader"]	["谁是entity的前任的领导者？"]
["vicepresident", "religion"]	["entity的副总统的宗教是什么？"]
["vicepresident", "before"]	["谁是entity的副总统的上一任？"]
["nominee", "parents"]	["谁养育了entity的提名人？","谁把entity的提名人抚养长大？","谁是entity的提名人的父母？"]
["受影响于", "almaMater"]	["P对entity带来影响的人从哪里毕业？"]
["leaderName", "youthWing"]	["entity的领导人的青年翼是什么？"]
["國家首都名稱", "caption"]	["entity的首都的标识是什么？"]
["neighbor", "subdivisionType"]	["entity的邻近城市的行政级别是什么？"]
["neighbor", "leaderName"]	["谁是entity的邻近城市的领导者？"]
["國家首都名稱", "p"]	["如何用汉语拼音拼写entity的首都？","entity的首都的中文拼音是什么？"]
["seat", "postalCodeType"]	["entity的行政中心使用什么类型的邮政编码？"]
["官方文字", "sign"]	["entity的官方语言使用什么样的语言？"]
["influenced", "logo"]	["受到entity影响的人的标识是什么？"]
["beforeElection", "nationality"]	["entity一CLPM任领导人的国籍是什么？"]
["官方語言", "agency"]	["哪个机构entity的官方语言属于哪个？"]
["leaderName", "as"]	["entity的领导人相当于什么？"]
["民族", "languages"]	["谁使用entity所属的民族的区域语言？"]
["國家首都名稱", "leaderName"]	["谁是entity的首都的领导者？"]
["最大城市名稱", "p"]	["如何用汉语拼音拼写entityA最大的城市？","entityA最大的城市的中文拼音是什么？"]
["fam", "type"]	["哪种类型是entity的？"]
["deputy", "predecessor"]	["谁是entity的代理人的前身？"]
["children", "successor"]	["谁是entity的子女的继承人？"]
["deathPlace", "title"]	["什么是entity逝世的地方的名字？"]
["region", "officialLanguages"]	["entity所在的行政区的官方语言是什么？"]
["writer", "successor"]	["谁是entity的作者的继承人？"]
["國家首都名稱", "timezone"]	["entity的首都属于哪个时区？"]
["最大城市名稱", "timezoneDst"]	["entityA最大的城市属于哪个时区？"]
["influenced", "almaMater"]	["受到entity影响的人从哪里毕业？"]
["children", "placeOfDeath"]	["entity的子女死在哪里？","这是entity的子女的死亡地点？"]
["官方語言", "sign"]	["entity的官方语言使用什么样的语言？"]
["country", "timezoneDst"]	["entity的属于哪个时区？"]
["官方文字", "script"]	["什么是entity的官方语言的盲文？"]
["influenced", "spouse"]	["谁是受到entity影响的人的配偶？"]
["office", "commander"]	["我们应该称之为entity担任的要职的指挥官？"]
["title", "eventEnd"]	["什么时候entity的标题解散了？"]
["issue", "before"]	["谁是entity的后裔的上一任？"]
["residence", "settlementType"]	["entity的居住地属于哪个地区？"]
["最大城市名稱", "northwest"]	["哪个地方位于entityA最大的城市的西北部？"]
["influenced", "placeOfDeath"]	["受到entity影响的人死在哪里？","这是受到entity影响的人的死亡地点？"]
["operatingSystem", "influenced"]	["谁影响了entity的操作系统？"]
["neighbor", "timezone"]	["entity的邻近城市属于哪个时区？"]
["state", "governmentType"]	["entity所在的州政府类型是什么？"]
["leader", "house"]	["entity的领导人有什么样的立法机构？"]
["successor", "leader"]	["谁是entity的一CLPM代产品的领导者？"]
["after", "deputy"]	["谁是entity的的部长？"]
["neighbor", "postalCodeType"]	["entity的邻近城市使用什么类型的邮政编码？"]
["before", "succession"]	["谁是entity的前任的继承人？"]
["alongside", "placeOfDeath"]	["P与entityA同时在任的政客死在哪里？","这是P与entityA同时在任的政客的死亡地点？"]
["allegiance", "house"]	["entity有什么样的立法机构？"]
["successor", "education"]	["entity的一CLPM代产品毕业的地方？","entity的一CLPM代产品从哪个学校毕业？"]
["discoverer", "doctoralStudents"]	["谁是entity的发现者的博士生？"]
["office", "wing"]	["女性的entity担任的要职翼是什么？"]
["predecessor", "currency"]	["entity的前代产品的货币是什么？"]
["title", "callingCode"]	["什么是entity的标题中的调用代码？"]
["最大城市名稱", "leaderName"]	["谁是entityA最大的城市的领导者？"]
["programmingLanguage", "family"]	["谁是entity的开发语言的家人？","谁是entity的开发语言的父亲？"]
["father", "predecessor"]	["谁是entity的父亲的前身？"]
["最大城市名稱", "governingBody"]	["entityA最大的城市的管理机构是什么？"]
["最大城市名稱", "establishedTitle"]	["哪个法律","行为使entityA最大的城市成立？"]
["spouse", "nationality"]	["entity的配偶的国籍是什么？"]
["birthPlace", "currency"]	["entity的出生地的货币是什么？"]
["developer", "affiliations"]	["entity的开发商隶属于什么机构？"]
["influenced", "placeOfBirth"]	["受到entity影响的人出生在哪里？"]
["capital", "timezoneDst"]	["entity的首都属于哪个时区？"]
["inaugural", "spouse"]	["谁是就职entity的政客的配偶？"]
["incumbent", "religion"]	["entity的现任的宗教是什么？"]
["origin", "religion"]	["entity的发源地的宗教是什么？"]
["國家首都名稱", "mayor"]	["谁是entity的首都的市长？"]
["senators", "candidate"]	["谁是entity的参议员的候选人？"]
["influenced", "children"]	["受到entity影响的人孩子的名字是什么？"]
["influenced", "parents"]	["谁养育了受到entity影响的人？","谁把受到entity影响的人抚养长大？","谁是受到entity影响的人的父母？"]
["place", "leader"]	["谁是entity的地址的领导者？"]
["senators", "predecessor"]	["谁是entity的参议员的前身？"]
["workplaces", "mascot"]	["什么是entity的工作地点的吉祥物？"]
["education", "ground"]	["entity的主场在哪里？"]
["最大城市名稱", "leaderTitle"]	["entityA最大的城市在哪里作为leaderTitle？"]
["popplace", "translitLang1Type"]	["什么是entity的主要分布区域的翻译方案？"]
["capital", "timezone1Dst"]	["entity的首都属于哪个时区？"]
["title", "event"]	["哪个文件","事件影响了entity的标题的灭绝并在欧洲结束了第二次世界大战？"]
["party", "lowerHouse"]	["什么是entity所属的党派的下议院？"]
["next", "children"]	["entity的一CLPM届奖项孩子的名字是什么？"]
["prev", "spouse"]	["谁是entity的的配偶？"]
["senators", "youthWing"]	["entity的参议员的青年翼是什么？"]
["state", "amphibian"]	["什么是IUCN脆弱的物种？青蛙？在entity所在的州？"]
["father", "successor"]	["谁是entity的父亲的继承人？"]
["senators", "ideology"]	["什么是entity的参议员的政治意识形态？"]
["senators", "wing"]	["女性的entity的参议员翼是什么？"]
["residence", "food"]	["entity的居住地中食物的无生命徽章是什么？"]
["educate", "provost"]	["谁是entity的教务长？"]
["country", "house"]	["entity的有什么样的立法机构？"]
["leaderName", "birthPlace"]	["entity的领导人出生在哪里？"]
["location", "insect"]	["什么样的昆虫是entity的位置特有的？"]
["nation", "caption"]	["entity所属国家的标识是什么？"]
["alongside", "children"]	["P与entityA同时在任的政客孩子的名字是什么？"]
["最大城市名稱", "timezone"]	["entityA最大的城市属于哪个时区？"]
["國家首都名稱", "subdivisionType"]	["entity的首都的行政级别是什么？"]
["educate", "logo"]	["entity的标识是什么？"]
["最大城市名稱", "subdivisionType"]	["entityA最大的城市的行政级别是什么？"]
["president", "issue"]	["谁是entity效力的总统的父母？"]
["influences", "title"]	["什么是entity的人的名字？"]
["issue", "predecessor"]	["谁是entity的后裔的前身？"]
["title", "titleLeader"]	["entity的标题中领导者的头衔是什么？"]
["neighbors", "subdivisionName"]	["entity的邻近区的细分名称是什么？"]
["neighbors", "leaderName"]	["谁是entity的邻近区的领导者？"]
["incumbent", "parents"]	["谁养育了entity的现任？","谁把entity的现任抚养长大？","谁是entity的现任的父母？"]
["nation", "legislature"]	["什么是entity所属国家的立法机关？"]
["next", "spouse"]	["谁是entity的一CLPM届奖项的配偶？"]
["neighbors", "settlementType"]	["entity的邻近区属于哪个地区？"]
["influenced", "nationality"]	["受到entity影响的人的国籍是什么？"]
["builder", "mother"]	["谁是entity的建造商的母亲？"]
["doctoralStudents", "almaMater"]	["entity的博士生从哪里毕业？"]
["predecessor", "bishop"]	["谁是entity的前代产品的主教？"]
["successor", "bishop"]	["谁是entity的一CLPM代产品的主教？"]
["capital", "leaderParty"]	["什么是entity的首都的领导方？"]
["國家首都名稱", "subdivisionName"]	["entity的首都的细分名称是什么？"]
["title", "establishedEvent"]	["什么时候entity的标题创建既定事件？"]
["region", "upperhouse"]	["我们用什么名字来称呼entity所在的行政区的上院？"]
["region", "lieutenantGovernor"]	["谁是entity所在的行政区现任副州长？"]
["educate", "caption"]	["entity的标识是什么？"]
["founder", "succession"]	["谁是entity的创始人的继承人？"]
["代表作", "label"]	["entity的代表作品的标签是什么？"]
["政权", "titleLeader"]	["entity的中领导者的头衔是什么？"]
["deathplace", "establishedEvent"]	["什么时候entity逝世的地方创建既定事件？"]
["region", "translitLang1Type"]	["什么是entity所在的行政区的翻译方案？"]
["leader", "before"]	["谁是entity的领导人的上一任？"]
["influences", "knownFor"]	["什么是entity的人知道的？"]
["developer", "knownFor"]	["什么是entity的开发商知道的？"]
["neighbor", "leaderTitle"]	["entity的邻近城市在哪里作为leaderTitle？"]
["代表作", "title"]	["什么是entity的代表作品的名字？"]
["neighbor", "callingCode"]	["什么是entity的邻近城市中的调用代码？"]
["location", "cities"]	["哪个列表按人口排列entity的位置中的城市地区？"]
["唱片公司", "industry"]	["entity与entity哪家唱片公司所属的产业类型是什么？"]
["主君", "title"]	["什么是entity效力的君主的名字？"]
["birthPlace", "fish"]	["什么是entity的出生地中的州鱼？"]
["所在地區", "leaderParty"]	["什么是entity的所属区域的领导方？"]
["format", "genre"]	["entity的节目形式属于哪种类型？"]
["placeOfDeath", "religion"]	["entity的逝世地址的宗教是什么？"]
["inaugural", "honorificPrefix"]	["就职entity的政客的荣誉称号是什么？"]
["族裔", "group"]	["entity的属于哪个组？"]
["birthPlace", "capital"]	["entity的出生地的首都在哪里？"]
["deathPlace", "titleLeader"]	["entity逝世的地方中领导者的头衔是什么？"]
["stadium", "settlementType"]	["举办entity的体育场属于哪个地区？"]
["nation", "label"]	["entity所属国家的标签是什么？"]
["居住地", "subdivisionName"]	["entity的居住地的细分名称是什么？"]
["almaMater", "principal"]	["谁是entity的母校的负责人？"]
["受影响于", "spouse"]	["谁是P对entity带来影响的人的配偶？"]
["seat", "founder"]	["谁是entity的行政中心的创始人？","谁创立了entity的行政中心？"]
["mostSuccessfulClub", "chairman"]	["谁是entity的生涯LC里A最成功的俱乐部的主席？"]
["leaderName", "ideology"]	["什么是entity的领导人的政治意识形态？"]
["predecessor", "as"]	["entity的前代产品相当于什么？"]
["office", "leaderName"]	["谁是entity担任的要职的领导者？"]
["mostSuccessfulClub", "owner"]	["谁是entity的生涯LC里A最成功的俱乐部的所有者？"]
["neighbors", "postalCodeType"]	["entity的邻近区使用什么类型的邮政编码？"]
["currentclub", "location"]	["entity在哪里？"]
["influences", "doctoralStudents"]	["谁是entity的人的博士生？"]
["spouse", "father"]	["谁是entity的配偶的父亲？"]
["primeminister", "party"]	["entity的首相属于哪一方？"]
["combatant", "deputy"]	["谁是entity的部长？"]
["states", "religion"]	["使用entity的地区的宗教是什么？"]
["before", "north"]	["哪个城市位于entity的前任的北部？"]
["政权", "event"]	["哪个文件","事件影响了entity的的灭绝并在欧洲结束了第二次世界大战？"]
["channel", "subsid"]	["entity的电视台子公司的名称是什么？"]
["before", "list2."]	["谁是1904年entity的前任最好的右手投手？"]
["after", "manager"]	["谁是entity的的经理？"]
["birthPlace", "p"]	["如何用汉语拼音拼写entity的出生地？","entity的出生地的中文拼音是什么？"]
["operator", "commander"]	["我们应该称之为entity的相关运营A方是的指挥官？"]
["cityofbirth", "leader"]	["谁是entity的出生地的领导者？"]
["教育程度", "regionalLanguages"]	["哪种语言是entity的毕业学校中的区域语言？"]
["title", "referee"]	["谁是entity的标题的裁判？"]
["place", "governor"]	["谁是entity的地址的现任州长？"]
["birthPlace", "mayor"]	["谁是entity的出生地的市长？"]
["location", "motto"]	["什么是entity的位置的座右铭？"]
["popplace", "officialReligion"]	["哪一项是entity的主要分布区域第一修正案的宗教条款中规定的受宪法保护的权利？"]
["popplace", "label"]	["entity的主要分布区域的标签是什么？"]
["doctoralAdvisor", "notableStudents"]	["谁是entity的博士生导师最着名的学生？"]
["operator", "caption"]	["entity的相关运营A方是的标识是什么？"]
["successor", "currency"]	["entity的一CLPM代产品的货币是什么？"]
["director", "influenced"]	["谁影响了entity的导演？"]
["連載雜誌", "author"]	["谁是连载entity的杂志的作者？"]
["languages", "child"]	["什么属于entity使用的语言？"]
["predecessor", "succession"]	["谁是entity的前代产品的继承人？"]
["neighbor", "translitLang1Type"]	["什么是entity的邻近城市的翻译方案？"]
["title", "region"]	["entity的标题属于哪个列表？","哪个列表包含entity的标题？"]
["nation", "governingBody"]	["entity所属国家的管理机构是什么？"]
["placeOfDeath", "officialReligion"]	["哪一项是entity的逝世地址第一修正案的宗教条款中规定的受宪法保护的权利？"]
["nation", "officialLanguages"]	["entity所属国家的官方语言是什么？"]
["主君", "placeOfDeath"]	["entity效力的君主死在哪里？","这是entity效力的君主的死亡地点？"]
["moreUsers", "leaderTitle"]	["使用entity的国家在哪里作为leaderTitle？"]
["leader", "leader"]	["谁是entity的领导人的领导者？"]
["plat", "logo"]	["entity的发布平台的标识是什么？"]
["office", "seat"]	["发现entity担任的要职的地方是什么？"]
["after", "ground"]	["entity的的主场在哪里？"]
["deathPlace", "governmentType"]	["entity逝世的地方政府类型是什么？"]
["deathPlace", "timezone"]	["entity逝世的地方属于哪个时区？"]
["locationCity", "soil"]	["entity的所在地的州土壤是什么？"]
["currentMembers", "label"]	["entity的现任成员的标签是什么？"]
["deathPlace", "southeast"]	["哪个城市位于entity逝世的地方的东南部？"]
["producer", "ancestry"]	["entity的制片人的家人来自哪里？","entity的制片人的故乡是什么？"]
["religion", "author"]	["谁是entity信仰的作者？"]
["location", "governor"]	["谁是entity的位置的现任州长？"]
["subdivisionName", "mayor"]	["谁是entity的市长？"]
["政权", "eventEnd"]	["什么时候entity的解散了？"]
["placeOfDeath", "house"]	["entity的逝世地址有什么样的立法机构？"]
["subdivisionName", "caption"]	["entity的标识是什么？"]
["頻道", "sisterNames"]	["什么是放映entity的频道的姐妹名字？"]
["所在", "leaderName"]	["谁是entity所在的城市的领导者？"]
["居住地", "callingCode"]	["什么是entity的居住地中的调用代码？"]
["leaderParty", "ideology"]	["什么是entity的的政治意识形态？"]
["garrison", "upperHouse"]	["什么是entity驻守的区域的上议院？"]
["garrison", "lowerHouse"]	["什么是entity驻守的区域的下议院？"]
["garrison", "leaderTitle"]	["entity驻守的区域在哪里作为leaderTitle？"]
["garrison", "religion"]	["entity驻守的区域的宗教是什么？"]
["garrison", "translitLang1Type"]	["什么是entity驻守的区域的翻译方案？"]
["birthPlace", "location"]	["entity的出生地在哪里？"]
["builder", "title"]	["什么是entity的建造商的名字？"]
["prev", "title"]	["什么是entity的的名字？"]
["citizenship", "governmentType"]	["entity的公民身份政府类型是什么？"]
["birthPlace", "seatType"]	["entity的出生地的行政级别是什么？"]
["nextAlbum", "writer"]	["谁写过entityLC之后的一CLPM部专辑？","谁是entityLC之后的一CLPM部专辑的作者？"]
["builder", "subsid"]	["entity的建造商子公司的名称是什么？"]
["region", "reptile"]	["什么是entity所在的行政区的官方国家爬行动物？"]
["region", "soil"]	["entity所在的行政区的州土壤是什么？"]
["owner", "lowerHouse"]	["什么是entity的总裁的下议院？"]
["occupation", "youthWing"]	["entity的职业的青年翼是什么？"]
["platform", "dialects"]	["entity的运行平台的方言是什么？"]
["leader", "governor"]	["谁是entity的领导人的现任州长？"]
["monarch", "house"]	["entity有什么样的立法机构？"]
["office", "party"]	["entity担任的要职属于哪一方？"]
["居住地", "timezone"]	["entity的居住地属于哪个时区？"]
["binomialAuthority", "associatedActs"]	["谁与entity的二项式命名法学名的相关联？"]
["province", "bishop"]	["谁是entity的主教？"]
["consecratedBy", "religion"]	["entity的的宗教是什么？"]
["title", "aircraftTransport"]	["什么是entity的标题的飞机运输？"]
["place", "operator"]	["哪个公司entity的地址属于？"]
["knownFor", "title"]	["什么是entity的成名作的名字？"]
["director", "placeOfBirth"]	["entity的导演出生在哪里？"]
["author", "genre"]	["entity的原著作者属于哪种类型？"]
["after", "knownFor"]	["什么是entity的知道的？"]
["title", "subsid"]	["entity的标题子公司的名称是什么？"]
["deathPlace", "lieutenantGovernor"]	["谁是entity逝世的地方现任副州长？"]
["doctoralStudents", "birthPlace"]	["entity的博士生出生在哪里？"]
["creator", "genre"]	["entity的创造者属于哪种类型？"]
["birthPlace", "southeast"]	["哪个城市位于entity的出生地的东南部？"]
["writer", "honorificSuffix"]	["entity的作者的敬语后缀是什么？"]
["notableCommanders", "title"]	["什么是entity的著名指挥官的名字？"]
["notableCommanders", "religion"]	["entity的著名指挥官的宗教是什么？"]
["areas", "butterfly"]	["在entity中发现了什么样的蝴蝶？"]
["order", "leader"]	["谁是P由entity担任领导的机构的领导者？"]
["areas", "label"]	["entity的标签是什么？"]
["deathPlace", "event"]	["哪个文件","事件影响了entity逝世的地方的灭绝并在欧洲结束了第二次世界大战？"]
["platform", "type"]	["哪种类型是entity的运行平台？"]
["branch", "leaderName"]	["谁是entity的的领导者？"]
["city", "ethnicGroups"]	["entity的所在城市属于哪个民族？"]
["birthPlace", "nickname"]	["entity的出生地的昵称是什么？"]
["predecessor", "house"]	["entity的前代产品有什么样的立法机构？"]
["father", "placeOfDeath"]	["entity的父亲死在哪里？","这是entity的父亲的死亡地点？"]
["house", "eventEnd"]	["什么时候entity所属的王朝解散了？"]
["nominee", "birthPlace"]	["entity的提名人出生在哪里？"]
["deathPlace", "p"]	["如何用汉语拼音拼写entity逝世的地方？","entity逝世的地方的中文拼音是什么？"]
["allegiance", "commander"]	["我们应该称之为entity的指挥官？"]
["beforeElection", "primeminister"]	["谁是entity一CLPM任领导人的首相？"]
["播放地區", "label"]	["entity的标签是什么？"]
["leaderName", "office"]	["entity的领导人的职务是什么？"]
["inaugural", "primeminister"]	["谁是就职entity的政客的首相？"]
["居住地", "leaderName"]	["谁是entity的居住地的领导者？"]
["areas", "officialReligion"]	["哪一项是entity第一修正案的宗教条款中规定的受宪法保护的权利？"]
["leaderName", "primeminister"]	["谁是entity的领导人的首相？"]
["managerclubs", "gk"]	["谁是entity执教的俱乐部的守门员？"]
["region", "region"]	["entity所在的行政区属于哪个列表？","哪个列表包含entity所在的行政区？"]
["programmingLanguage", "logo"]	["entity的开发语言的标识是什么？"]
["popplace", "p"]	["如何用汉语拼音拼写entity的主要分布区域？","entity的主要分布区域的中文拼音是什么？"]
["company", "sisterNames"]	["什么是entity的运营公司的姐妹名字？"]
["father", "office"]	["entity的父亲的职务是什么？"]
["precededBy", "voices"]	["谁是entity的一CLPM部作品中的配音演员？"]
["國家", "label"]	["entity所属的国家的标签是什么？"]
["mother", "father"]	["谁是entity的母亲的父亲？"]
["stadium", "establishedTitle"]	["哪个法律","行为使举办entity的体育场成立？"]
["nationality", "legislature"]	["什么是entity的国籍的立法机关？"]
["usedBy", "ideology"]	["什么是entity的使用者的政治意识形态？"]
["parent", "affiliations"]	["entity的主公司隶属于什么机构？"]
["主君", "deathPlace"]	["entity效力的君主死在哪里？","entity效力的君主的死亡地点是什么？"]
["lyrics", "spouse"]	["谁是entity的的配偶？"]
["現任成員", "occupation"]	["entity的现任成员从事的职业是什么？","entity的现任成员的工作是什么？"]
["nationalteam", "gk"]	["谁是entity的守门员？"]
["managerclubs", "type"]	["哪种类型是entity执教的俱乐部？"]
["state", "callingCode"]	["什么是entity所在的州中的调用代码？"]
["headquarters", "upperHouse"]	["什么是entity的总部地址的上议院？"]
["producer", "parents"]	["谁养育了entity的制片人？","谁把entity的制片人抚养长大？","谁是entity的制片人的父母？"]
["workplaces", "founder"]	["谁是entity的工作地点的创始人？","谁创立了entity的工作地点？"]
["title", "successor"]	["谁是entity的标题的继承人？"]
["father", "father"]	["谁是entity的父亲的父亲？"]
["next", "directedby"]	["谁导演entity的一CLPM届奖项？","谁是entity的一CLPM届奖项的导演？"]
["house", "titleLeader"]	["entity所属的王朝中领导者的头衔是什么？"]
["residence", "northwest"]	["哪个地方位于entity的居住地的西北部？"]
["leader", "children"]	["entity的领导人孩子的名字是什么？"]
["champion", "list1."]	["谁是第一个在entity的总冠军中添加内容的人？"]
["deathPlace", "leader"]	["谁是entity逝世的地方的领导者？"]
["workInstitution", "industry"]	["entity的工作机构所属的产业类型是什么？"]
["areaServed", "southeast"]	["哪个城市位于entity的服务区域的东南部？"]
["nationality", "currency"]	["entity的国籍的货币是什么？"]
["combatant", "establishedEvent"]	["什么时候entity创建既定事件？"]
["almaMater", "tree"]	["什么树大部分种植在entity的母校？"]
["title", "bishop"]	["谁是entity的标题的主教？"]
["headquarters", "region"]	["entity的总部地址属于哪个列表？","哪个列表包含entity的总部地址？"]
["locale", "largestmetro"]	["entityEV的所属地点最大的地铁在哪里？"]
["身份", "ethnicGroups"]	["entity所在的朝代属于哪个民族？"]
["nominee", "primeminister"]	["谁是entity的提名人的首相？"]
["nominee", "placeOfBirth"]	["entity的提名人出生在哪里？"]
["afterElection", "primeminister"]	["谁是entity的胜选者的首相？"]
["predecessor", "type"]	["哪种类型是entity的前代产品？"]
["deathPlace", "sovereigntyType"]	["什么是entity逝世的地方的主权类型？"]
["deputy", "birthPlace"]	["entity的代理人出生在哪里？"]
["start", "architect"]	["谁是entity的起点站的建筑师？","谁建立了entity的起点站？"]
["house", "founder"]	["谁是entity所属的王朝的创始人？","谁创立了entity所属的王朝？"]
["mostSuccessfulClub", "ground"]	["entity的生涯LC里A最成功的俱乐部的主场在哪里？"]
["placeOfDeath", "leaderTitle"]	["entity的逝世地址在哪里作为leaderTitle？"]
["popplace", "lowerHouse"]	["什么是entity的主要分布区域的下议院？"]
["channel", "keyPeople"]	["谁是entity的电视台的首席执行官？"]
["province", "type"]	["哪种类型是entity？"]
["經紀公司", "sisterNames"]	["什么是entity的经济公司的姐妹名字？"]
["職業", "ancestor"]	["entity的职业的祖先在哪里？"]
["popplace", "subdivisionType"]	["entity的主要分布区域的行政级别是什么？"]
["occupation", "industry"]	["entity的职业所属的产业类型是什么？"]
["citizenship", "officialLanguages"]	["entity的公民身份的官方语言是什么？"]
["placeOfBirth", "p"]	["如何用汉语拼音拼写entity的出生地？","entity的出生地的中文拼音是什么？"]
["company", "genre"]	["entity的运营公司属于哪种类型？"]
["region", "north"]	["哪个城市位于entity所在的行政区的北部？"]
["mother", "placeOfBirth"]	["entity的母亲出生在哪里？"]
["predecessor", "keyPeople"]	["谁是entity的前代产品的首席执行官？"]
["designer", "type"]	["哪种类型是entity的设计者？"]
["influences", "relatives"]	["谁是entity的人的亲戚？"]
["next", "father"]	["谁是entity的一CLPM届奖项的父亲？"]
["所在", "label"]	["entity所在的城市的标签是什么？"]
["主演", "spouse"]	["谁是entity的演员的配偶？"]
["start", "settlementType"]	["entity的起点站属于哪个地区？"]
["occupation", "ancestor"]	["entity的职业的祖先在哪里？"]
["subdivisionName", "event"]	["哪个文件","事件影响了entity的灭绝并在欧洲结束了第二次世界大战？"]
["origin", "postalCodeType"]	["entity的发源地使用什么类型的邮政编码？"]
["author", "chancellor"]	["谁是entity的原著作者的总理？"]
["母校", "chairman"]	["谁是entity的母校的主席？"]
["operator", "list1."]	["谁是第一个在entity的相关运营A方是中添加内容的人？"]
["poleTeam", "logo"]	["entity的优胜车队的标识是什么？"]
["house", "caption"]	["entity所属的王朝的标识是什么？"]
["title", "stylisticOrigins"]	["entity的标题的风格起源是什么？"]
["territory", "leaderParty"]	["什么是entity覆盖的区域的领导方？"]
["deputy", "deathPlace"]	["entity的代理人死在哪里？","entity的代理人的死亡地点是什么？"]
["spouse", "family"]	["谁是entity的配偶的家人？","谁是entity的配偶的父亲？"]
["residence", "p"]	["如何用汉语拼音拼写entity的居住地？","entity的居住地的中文拼音是什么？"]
["garrison", "type"]	["哪种类型是entity驻守的区域？"]
["stadium", "legislature"]	["什么是举办entity的体育场的立法机关？"]
["garrison", "areaCodeType"]	["entity驻守的区域有哪些类型的区号？"]
["stadium", "nickname"]	["举办entity的体育场的昵称是什么？"]
["managerclubs", "topScorer"]	["谁是entity执教的俱乐部的最佳射手？"]
["workInstitution", "founder"]	["谁是entity的工作机构的创始人？","谁创立了entity的工作机构？"]
["placeOfBirth", "subdivisionName"]	["entity的出生地的细分名称是什么？"]
["battles", "languages"]	["谁使用entity参加的战争的区域语言？"]
["owner", "predecessor"]	["谁是entity的总裁的前身？"]
["leader", "president"]	["谁是entity的领导人的总裁？"]
["constituencyWestminster", "party"]	["entity的选区属于哪一方？"]
["title", "homeStadium"]	["什么是entity的标题的主场？"]
["ethnicity", "group"]	["entity属于哪个组？"]
["owner", "subdivisionType"]	["entity的总裁的行政级别是什么？"]
["operator", "subsid"]	["entity的相关运营A方是子公司的名称是什么？"]
["label", "leaderTitle"]	["entity的标签在哪里作为leaderTitle？"]
["president", "event"]	["哪个文件","事件影响了entity效力的总统的灭绝并在欧洲结束了第二次世界大战？"]
["cities", "southwest"]	["位于entity西南的是什么？"]
["territory", "religion"]	["entity覆盖的区域的宗教是什么？"]
["subdivisionName", "countryHeading"]	["entity最终得到了什么？"]
["associatedActs", "genre"]	["entity的相关艺人属于哪种类型？"]
["deathPlace", "soil"]	["entity逝世的地方的州土壤是什么？"]
["locale", "soil"]	["entityEV的所属地点的州土壤是什么？"]
["origin", "operator"]	["哪个公司entity的发源地属于？"]
["areas", "timezoneDst"]	["entity属于哪个时区？"]
["stadium", "location"]	["举办entity的体育场在哪里？"]
["placeOfBirth", "caption"]	["entity的出生地的标识是什么？"]
["出生地", "caption"]	["entity的出生地的标识是什么？"]
["居住地", "leaderTitle"]	["entity的居住地在哪里作为leaderTitle？"]
["主演", "settlementType"]	["entity的演员属于哪个地区？"]
["birthplace", "legislature"]	["什么是entityO第一CLPM支登场的球队的立法机关？"]
["ground", "legislature"]	["什么是entity的地址的立法机关？"]
["educate", "affiliation"]	["谁隶属于entity？"]
["developer", "commander"]	["我们应该称之为entity的开发商的指挥官？"]
["currentMembers", "birthPlace"]	["entity的现任成员出生在哪里？"]
["seat", "leaderName"]	["谁是entity的行政中心的领导者？"]
["location", "highestpoint"]	["entity的位置的最高点是什么？"]
["workInstitution", "mascot"]	["什么是entity的工作机构的吉祥物？"]
["notableCommanders", "deputy"]	["谁是entity的著名指挥官的部长？"]
["國家", "currency"]	["entity所属的国家的货币是什么？"]
["製作", "divisions"]	["哪个唱片公司的entity的制作方拥有？"]
["籍貫", "governmentType"]	["entity的籍贯政府类型是什么？"]
["播放地區", "governor"]	["谁是entity的现任州长？"]
["spouse", "governmentType"]	["entity的配偶政府类型是什么？"]
["currentclub", "p"]	["如何用汉语拼音拼写entity？","entity的中文拼音是什么？"]
["successor", "nationality"]	["entity的一CLPM代产品的国籍是什么？"]
["locationCity", "callingCode"]	["什么是entity的所在地中的调用代码？"]
["place", "mammal"]	["entity的地址中濒临灭绝的哺乳动物是什么？"]
["office", "motto"]	["什么是entity担任的要职的座右铭？"]
["affiliation", "president"]	["谁是entity的隶属机构的总裁？"]
["capital", "areaCodeType"]	["entity的首都有哪些类型的区号？"]
["occupation", "producer"]	["谁是entity的职业的制片人？"]
["house", "leader"]	["谁是entity所属的王朝的领导者？"]
["placeOfDeath", "nickname"]	["entity的逝世地址的昵称是什么？"]
["locale", "postalCode"]	["什么是entityEV的所属地点的邮政编码？"]
["主持", "placeOfBirth"]	["entity的主持人出生在哪里？"]
["music", "honorificPrefix"]	["entity的配乐作者的荣誉称号是什么？"]
["動畫製作", "divisions"]	["哪个唱片公司的entity的动画拥有？"]
["director", "almaMater"]	["entity的导演从哪里毕业？"]
["producer", "almaMater"]	["entity的制片人从哪里毕业？"]
["awards", "language"]	["entity获得的奖项的语言是什么？"]
["residence", "governmentType"]	["entity的居住地政府类型是什么？"]
["writer", "family"]	["谁是entity的作者的家人？","谁是entity的作者的父亲？"]
["occupation", "company"]	["哪个公司entity的职业属于？"]
["genusAuthority", "nationality"]	["entity的属PRU（生物PRU（）的命名者的国籍是什么？"]
["出生地點", "subdivisionName"]	["entity的出生地点的细分名称是什么？"]
["军阶", "caption"]	["entity的军阶的标识是什么？"]
["origin", "officialReligion"]	["哪一项是entity的发源地第一修正案的宗教条款中规定的受宪法保护的权利？"]
["similar", "caption"]	["P与entity相似的车型的标识是什么？"]
["after", "leaderTitle"]	["entity的在哪里作为leaderTitle？"]
["唱片公司", "legislature"]	["什么是entity与entity哪家唱片公司的立法机关？"]
["經紀公司", "governmentType"]	["entity的经济公司政府类型是什么？"]
["fam", "region"]	["entity的属于哪个列表？","哪个列表包含entity的？"]
["capital", "postalCodeType"]	["entity的首都使用什么类型的邮政编码？"]
["city", "translitLang1Type"]	["什么是entity的所在城市的翻译方案？"]
["deathPlace", "lowerHouse"]	["什么是entity逝世的地方的下议院？"]
["birthPlace", "titleLeader"]	["entity的出生地中领导者的头衔是什么？"]
["after", "family"]	["谁是entity的的家人？","谁是entity的的父亲？"]
["doctoralAdvisor", "almaMater"]	["entity的博士生导师从哪里毕业？"]
["deathPlace", "religion"]	["entity逝世的地方的宗教是什么？"]
["developer", "predecessor"]	["谁是entity的开发商的前身？"]
["combatant", "founder"]	["谁是entity的创始人？","谁创立了entity？"]
["自治體", "region"]	["entity的地方政府属于哪个列表？","哪个列表包含entity的地方政府？"]
["operator", "logo"]	["entity的相关运营A方是的标识是什么？"]
["religion", "leaderName"]	["谁是entity信仰的领导者？"]
["citizenship", "sovereigntyType"]	["什么是entity的公民身份的主权类型？"]
["garrison", "governor"]	["谁是entity驻守的区域的现任州长？"]
["allegiance", "event"]	["哪个文件","事件影响了entity的灭绝并在欧洲结束了第二次世界大战？"]
["residence", "upperhouse"]	["我们用什么名字来称呼entity的居住地的上院？"]
["combatant", "postalCodeType"]	["entity使用什么类型的邮政编码？"]
["代表作", "author"]	["谁是entity的代表作品的作者？"]
["製作", "type"]	["哪种类型是entity的制作方？"]
["popplace", "title"]	["什么是entity的主要分布区域的名字？"]
["countryofbirth", "areaCodeType"]	["entity的祖国有哪些类型的区号？"]
["title", "before"]	["谁是entity的标题的上一任？"]
["title", "manager"]	["谁是entity的标题的经理？"]
["cityofbirth", "isoCode"]	["什么是entity的出生地的ISO代码？"]
["products", "callingCode"]	["什么是entity的产品中的调用代码？"]
["播放地區", "languages"]	["谁使用entity的区域语言？"]
["region", "officialReligion"]	["哪一项是entity所在的行政区第一修正案的宗教条款中规定的受宪法保护的权利？"]
["usedBy", "religion"]	["entity的使用者的宗教是什么？"]
["電視台", "callingCode"]	["什么是播放entity的电视台中的调用代码？"]
["birthPlace", "timezoneDst"]	["entity的出生地属于哪个时区？"]
["plat", "label"]	["entity的发布平台的标签是什么？"]
["自治體", "subdivisionName"]	["entity的地方政府的细分名称是什么？"]
["owner", "lcb"]	["谁是entity的总裁的着名前球员？"]
["primaryUser", "regionalLanguages"]	["哪种语言是entity的主要用户中的区域语言？"]
["spouse", "placeOfDeath"]	["entity的配偶死在哪里？","这是entity的配偶的死亡地点？"]
["locationCity", "timezone"]	["entity的所在地属于哪个时区？"]
["代表作", "occupation"]	["entity的代表作品从事的职业是什么？","entity的代表作品的工作是什么？"]
["next", "stadium"]	["entity的一CLPM届奖项在哪里训练？"]
["incumbent", "before"]	["谁是entity的现任的上一任？"]
["deathplace", "north"]	["哪个城市位于entity逝世的地方的北部？"]
["publisher", "type"]	["哪种类型是entity的出版商？"]
["國家", "establishedEvent"]	["什么时候entity所属的国家创建既定事件？"]
["languages", "agency"]	["哪个机构entity使用的语言属于哪个？"]
["after", "executiveProducer"]	["谁是entity的的执行制片人？"]
["主演", "nationality"]	["entity的演员的国籍是什么？"]
["successor", "governor"]	["谁是entity的一CLPM代产品的现任州长？"]
["knownFor", "voices"]	["谁是entity的成名作中的配音演员？"]
["allegiance", "sovereigntyType"]	["什么是entity的主权类型？"]
["next", "office"]	["entity的一CLPM届奖项的职务是什么？"]
["garrison", "northeast"]	["位于entity驻守的区域东北的地方是什么？"]
["citizenship", "leaderName"]	["谁是entity的公民身份的领导者？"]
["所在", "subdivisionName"]	["entity所在的城市的细分名称是什么？"]
["before", "deathPlace"]	["entity的前任死在哪里？","entity的前任的死亡地点是什么？"]
["出生地", "label"]	["entity的出生地的标签是什么？"]
["locale", "governingBody"]	["entityEV的所属地点的管理机构是什么？"]
["founder", "deathPlace"]	["entity的创始人死在哪里？","entity的创始人的死亡地点是什么？"]
["使用平台", "updatemodel"]	["entity的使用平台更新模型的名称是什么？"]
["出生地點", "subdivisionType"]	["entity的出生地点的行政级别是什么？"]
["出生地", "settlementType"]	["entity的出生地属于哪个地区？"]
["出生地", "capital"]	["entity的出生地的首都在哪里？"]
["next", "tenants"]	["哪个俱乐部entity的一CLPM届奖项租给哪个？","哪个俱乐部做租客entity的一CLPM届奖项？"]
["placeOfBirth", "nickname"]	["entity的出生地的昵称是什么？"]
["territory", "northwest"]	["哪个地方位于entity覆盖的区域的西北部？"]
["placeOfDeath", "lowerHouse"]	["什么是entity的逝世地址的下议院？"]
["nation", "titleLeader"]	["entity所属国家中领导者的头衔是什么？"]
["precededBy", "executiveProducer"]	["谁是entity的一CLPM部作品的执行制片人？"]
["occupation", "southeast"]	["哪个城市位于entity的职业的东南部？"]
["precededBy", "company"]	["哪个公司entity的一CLPM部作品属于？"]
["出生地點", "governor"]	["谁是entity的出生地点的现任州长？"]
["placeOfBirth", "governingBody"]	["entity的出生地的管理机构是什么？"]
["territory", "ethnicGroups"]	["entity覆盖的区域属于哪个民族？"]
["owner", "callingCode"]	["什么是entity的总裁中的调用代码？"]
["workplaces", "caption"]	["entity的工作地点的标识是什么？"]
["currentMembers", "currentMembers"]	["谁是entity的现任成员的现任乐队领队？"]
["inaugural", "predecessor"]	["谁是就职entity的政客的前身？"]
["occupation", "divisions"]	["哪个唱片公司的entity的职业拥有？"]
["platform", "influenced"]	["谁影响了entity的运行平台？"]
["primaryUser", "leaderTitle"]	["entity的主要用户在哪里作为leaderTitle？"]
["primaryUser", "religion"]	["entity的主要用户的宗教是什么？"]
["primaryUser", "upperHouse"]	["什么是entity的主要用户的上议院？"]
["时代", "governmentType"]	["entity哪个时代政府类型是什么？"]
["education", "mascot"]	["什么是entity的吉祥物？"]
["order", "demonym"]	["我们称之为P由entity担任领导的机构的人是谁？"]
["deathPlace", "demonym"]	["我们称之为entity逝世的地方的人是谁？"]
["placeOfDeath", "ethnicGroups"]	["entity的逝世地址属于哪个民族？"]
["title", "ethnicGroups"]	["entity的标题属于哪个民族？"]
["現任成員", "before"]	["谁是entity的现任成员的上一任？"]
["author", "placeOfDeath"]	["entity的原著作者死在哪里？","这是entity的原著作者的死亡地点？"]
["seat", "establishedTitle"]	["哪个法律","行为使entity的行政中心成立？"]
["leaderName", "party"]	["entity的领导人属于哪一方？"]
["deputy", "as"]	["entity的代理人相当于什么？"]
["官方文字", "ancestor"]	["entity的官方语言的祖先在哪里？"]
["國家首都名稱", "settlementType"]	["entity的首都属于哪个地区？"]
["incumbent", "bishop"]	["谁是entity的现任的主教？"]
["after", "honorificSuffix"]	["entity的的敬语后缀是什么？"]
["influences", "notableStudents"]	["谁是entity的人最着名的学生？"]
["influenced", "religion"]	["受到entity影响的人的宗教是什么？"]
["alongside", "religion"]	["P与entityA同时在任的政客的宗教是什么？"]
["placeOfBirth", "religion"]	["entity的出生地的宗教是什么？"]
["children", "religion"]	["entity的子女的宗教是什么？"]
["currentMembers", "spouse"]	["谁是entity的现任成员的配偶？"]
["successor", "president"]	["谁是entity的一CLPM代产品的总裁？"]
["educate", "p"]	["如何用汉语拼音拼写entity？","entity的中文拼音是什么？"]
["inaugural", "before"]	["谁是就职entity的政客的上一任？"]
["senators", "before"]	["谁是entity的参议员的上一任？"]
["region", "cities"]	["哪个列表按人口排列entity所在的行政区中的城市地区？"]
["spouse", "office"]	["entity的配偶的职务是什么？"]
["monarch", "before"]	["谁是entity的上一任？"]
["教育程度", "demonym"]	["我们称之为entity的毕业学校的人是谁？"]
["最大城市名稱", "areaCodeType"]	["entityA最大的城市有哪些类型的区号？"]
["國家首都名稱", "leaderTitle"]	["entity的首都在哪里作为leaderTitle？"]
["leaderName", "predecessor"]	["谁是entity的领导人的前身？"]
["influences", "deathPlace"]	["entity的人死在哪里？","entity的人的死亡地点是什么？"]
["doctoralStudents", "notableStudents"]	["谁是entity的博士生最着名的学生？"]
["nationality", "title"]	["什么是entity的国籍的名字？"]
["senators", "successor"]	["谁是entity的参议员的继承人？"]
["basinCountries", "officialLanguages"]	["entity的沿线国家的官方语言是什么？"]
["leaderName", "successor"]	["谁是entity的领导人的继承人？"]
["father", "religion"]	["entity的父亲的宗教是什么？"]
["senators", "placeOfBirth"]	["entity的参议员出生在哪里？"]
["spouse", "occupation"]	["entity的配偶从事的职业是什么？","entity的配偶的工作是什么？"]
["province", "translitLang1Type"]	["什么是entity的翻译方案？"]
["region", "tree"]	["什么树大部分种植在entity所在的行政区？"]
["leader", "as"]	["entity的领导人相当于什么？"]
["state", "subdivisionName"]	["entity所在的州的细分名称是什么？"]
["neighbor", "upperHouse"]	["什么是entity的邻近城市的上议院？"]
["successor", "industry"]	["entity的一CLPM代产品所属的产业类型是什么？"]
["origin", "regionalLanguages"]	["哪种语言是entity的发源地中的区域语言？"]
["incumbent", "honorificSuffix"]	["entity的现任的敬语后缀是什么？"]
["next", "issue"]	["谁是entity的一CLPM届奖项的父母？"]
["territory", "leader"]	["谁是entity覆盖的区域的领导者？"]
["所在地區", "subdivisionType"]	["entity的所属区域的行政级别是什么？"]
["籍貫", "leaderTitle"]	["entity的籍贯在哪里作为leaderTitle？"]
["mother", "deathPlace"]	["entity的母亲死在哪里？","entity的母亲的死亡地点是什么？"]
["monarch", "predecessor"]	["谁是entity的前身？"]
["neighbors", "subdivisionType"]	["entity的邻近区的行政级别是什么？"]
["mother", "house"]	["entity的母亲有什么样的立法机构？"]
["region", "caption"]	["entity所在的行政区的标识是什么？"]
["prev", "mother"]	["谁是entity的的母亲？"]
["predecessor", "nationality"]	["entity的前代产品的国籍是什么？"]
["mother", "religion"]	["entity的母亲的宗教是什么？"]
["combatant", "eventEnd"]	["什么时候entity解散了？"]
["allegiance", "callingCode"]	["什么是entity中的调用代码？"]
["title", "ground"]	["entity的标题的主场在哪里？"]
["languages", "region"]	["entity使用的语言属于哪个列表？","哪个列表包含entity使用的语言？"]
["subdivisionName", "north"]	["哪个城市位于entity的北部？"]
["studio", "satServ"]	["什么是制作entity的工作室的母公司？"]
["教育程度", "chancellor"]	["谁是entity的毕业学校的总理？"]
["capital", "northwest"]	["哪个地方位于entity的首都的西北部？"]
["incumbent", "issue"]	["谁是entity的现任的父母？"]
["電視網", "language"]	["播放entity的电视台的语言是什么？"]
["owner", "services"]	["什么包含在entity的总裁的服务中？"]
["affiliation", "type"]	["哪种类型是entity的隶属机构？"]
["usedBy", "currency"]	["entity的使用者的货币是什么？"]
["origin", "grass"]	["什么样的草原产于entity的发源地？"]
["deathPlace", "northwest"]	["哪个地方位于entity逝世的地方的西北部？"]
["county", "subdivisionType"]	["entity所属的省份的行政级别是什么？"]
["birthplace", "mayor"]	["谁是entityO第一CLPM支登场的球队的市长？"]
["deathplace", "religion"]	["entity逝世的地方的宗教是什么？"]
["deathplace", "upperHouse"]	["什么是entity逝世的地方的上议院？"]
["出生地", "governmentType"]	["entity的出生地政府类型是什么？"]
["owner", "satServ"]	["什么是entity的总裁的母公司？"]
["state", "before"]	["谁是entity所在的州的上一任？"]
["writer", "parents"]	["谁养育了entity的作者？","谁把entity的作者抚养长大？","谁是entity的作者的父母？"]
["country", "script"]	["什么是entity的的盲文？"]
["popplace", "establishedTitle"]	["哪个法律","行为使entity的主要分布区域成立？"]
["operator", "list3."]	["entity的相关运营A方是为之奋斗的第三支职业球队是什么？"]
["residence", "location"]	["entity的居住地在哪里？"]
["doctoralStudents", "title"]	["什么是entity的博士生的名字？"]
["origin", "label"]	["entity的发源地的标签是什么？"]
["successor", "affiliation"]	["谁隶属于entity的一CLPM代产品？"]
["influences", "before"]	["谁是entity的人的上一任？"]
["職業", "type"]	["哪种类型是entity的职业？"]
["origin", "capital"]	["entity的发源地的首都在哪里？"]
["動畫製作", "subsid"]	["entity的动画子公司的名称是什么？"]
["region", "largestmetro"]	["entity所在的行政区最大的地铁在哪里？"]
["deathplace", "lowerHouse"]	["什么是entity逝世的地方的下议院？"]
["commander", "father"]	["谁是entity的将领的父亲？"]
["inaugural", "children"]	["就职entity的政客孩子的名字是什么？"]
["states", "timezone"]	["使用entity的地区属于哪个时区？"]
["doctoralAdvisor", "influences"]	["谁影响entity的博士生导师？"]
["popplace", "southwest"]	["位于entity的主要分布区域西南的是什么？"]
["leader", "candidate"]	["谁是entity的领导人的候选人？"]
["locale", "lowerHouse"]	["什么是entityEV的所属地点的下议院？"]
["city", "founder"]	["谁是entity的所在城市的创始人？","谁创立了entity的所在城市？"]
["before", "tenants"]	["哪个俱乐部entity的前任租给哪个？","哪个俱乐部做租客entity的前任？"]
["locale", "north"]	["哪个城市位于entityEV的所属地点的北部？"]
["country", "p"]	["如何用汉语拼音拼写entity的？","entity的的中文拼音是什么？"]
["inaugural", "deputy"]	["谁是就职entity的政客的部长？"]
["ethnicity", "caption"]	["entity的标识是什么？"]
["workplaces", "successor"]	["谁是entity的工作地点的继承人？"]
["代表作", "magazine"]	["哪个杂志是entity的代表作品发表在哪？"]
["archipelago", "leaderTitle"]	["entity的在哪里作为leaderTitle？"]
["countryAdminDivisions", "leaderTitle"]	["entity在哪里作为leaderTitle？"]
["代表作", "placeOfDeath"]	["entity的代表作品死在哪里？","这是entity的代表作品的死亡地点？"]
["doctoralAdvisor", "spouse"]	["谁是entity的博士生导师的配偶？"]
["製作", "logo"]	["entity的制作方的标识是什么？"]
["after", "architect"]	["谁是entity的的建筑师？","谁建立了entity的？"]
["managerclubs", "rcb"]	["谁是entity执教的俱乐部最强的玩家？"]
["title", "list2."]	["谁是1904年entity的标题最好的右手投手？"]
["primaryUser", "establishedEvent"]	["什么时候entity的主要用户创建既定事件？"]
["location", "reptile"]	["什么是entity的位置的官方国家爬行动物？"]
["publisher", "president"]	["谁是entity的出版商的总裁？"]
["workInstitutions", "type"]	["哪种类型是entity的工作机构？"]
["locationCity", "southeast"]	["哪个城市位于entity的所在地的东南部？"]
["areaServed", "leaderTitle"]	["entity的服务区域在哪里作为leaderTitle？"]
["經紀公司", "subsid"]	["entity的经济公司子公司的名称是什么？"]
["creator", "nationality"]	["entity的创造者的国籍是什么？"]
["territory", "demonym"]	["我们称之为entity覆盖的区域的人是谁？"]
["province", "isoCode"]	["什么是entity的ISO代码？"]
["province", "seat"]	["发现entity的地方是什么？"]
["province", "leader"]	["谁是entity的领导者？"]
["region", "sign"]	["entity所在的行政区使用什么样的语言？"]
["publisher", "successor"]	["谁是entity的出版商的继承人？"]
["appointer", "as"]	["entity的任命者相当于什么？"]
["territory", "establishedEvent"]	["什么时候entity覆盖的区域创建既定事件？"]
["headquarters", "areaCodeType"]	["entity的总部地址有哪些类型的区号？"]
["territory", "governor"]	["谁是entity覆盖的区域的现任州长？"]
["author", "successor"]	["谁是entity的原著作者的继承人？"]
["region", "isoCode"]	["什么是entity所在的行政区的ISO代码？"]
["poleTeam", "keyPeople"]	["谁是entity的优胜车队的首席执行官？"]
["place", "populationBlank1Title"]	["什么是entity的地址？"]
["occupation", "list1."]	["谁是第一个在entity的职业中添加内容的人？"]
["currentclub", "before"]	["谁是entity的上一任？"]
["政权", "title"]	["什么是entity的的名字？"]
["usedBy", "commander"]	["我们应该称之为entity的使用者的指挥官？"]
["youthclubs", "before"]	["谁是entity所属青年俱乐部的上一任？"]
["居住地", "religion"]	["entity的居住地的宗教是什么？"]
["currentclub", "leaderName"]	["谁是entity的领导者？"]
["instrument", "instruments"]	["entity使用的乐器使用什么工具？"]
["associatedActs", "birthPlace"]	["entity的相关艺人出生在哪里？"]
["mother", "leaderName"]	["谁是entity的母亲的领导者？"]
["placeOfDeath", "title"]	["什么是entity的逝世地址的名字？"]
["followedBy", "title"]	["什么是entity的一CLPM部作品的名字？"]
["programmingLanguage", "genre"]	["entity的开发语言属于哪种类型？"]
["birthplace", "lowerHouse"]	["什么是entityO第一CLPM支登场的球队的下议院？"]
["platform", "successor"]	["谁是entity的运行平台的继承人？"]
["出生地點", "areaCodeType"]	["entity的出生地点有哪些类型的区号？"]
["出生地點", "governingBody"]	["entity的出生地点的管理机构是什么？"]
["出生地點", "leaderName"]	["谁是entity的出生地点的领导者？"]
["areaServed", "officialLanguages"]	["entity的服务区域的官方语言是什么？"]
["location", "populationBlank1Title"]	["什么是entity的位置？"]
["locale", "lieutenantGovernor"]	["谁是entityEV的所属地点现任副州长？"]
["residence", "populationBlank1Title"]	["什么是entity的居住地？"]
["incumbent", "spouse"]	["谁是entity的现任的配偶？"]
["頻道", "format"]	["放映entity的频道的格式是什么？"]
["before", "nationality"]	["entity的前任的国籍是什么？"]
["commander", "as"]	["entity的将领相当于什么？"]
["commander", "almaMater"]	["entity的将领从哪里毕业？"]
["使用平臺", "supportedPlatforms"]	["entity的发布平台支持哪些平台？"]
["出生地點", "governmentType"]	["entity的出生地点政府类型是什么？"]
["producer", "keyPeople"]	["谁是entity的制片人的首席执行官？"]
["place", "religion"]	["entity的地址的宗教是什么？"]
["place", "sovereigntyType"]	["什么是entity的地址的主权类型？"]
["出生地", "sovereigntyType"]	["什么是entity的出生地的主权类型？"]
["leaderParty", "founder"]	["谁是entity的的创始人？","谁创立了entity的？"]
["before", "religion"]	["entity的前任的宗教是什么？"]
["cityofbirth", "translitLang1Type"]	["什么是entity的出生地的翻译方案？"]
["usedBy", "label"]	["entity的使用者的标签是什么？"]
["place", "soil"]	["entity的地址的州土壤是什么？"]
["place", "seallink"]	["什么是entity的地址的密封链接？"]
["place", "bird"]	["哪种鸟类生物居住在entity的地址？"]
["place", "butterfly"]	["在entity的地址中发现了什么样的蝴蝶？"]
["place", "lieutenantGovernor"]	["谁是entity的地址现任副州长？"]
["place", "before"]	["谁是entity的地址的上一任？"]
["region", "location"]	["entity所在的行政区在哪里？"]
["builder", "location"]	["entity的建造商在哪里？"]
["occupation", "instruments"]	["entity的职业使用什么工具？"]
["channel", "founder"]	["谁是entity的电视台的创始人？","谁创立了entity的电视台？"]
["owner", "owner"]	["谁是entity的总裁的所有者？"]
["garrison", "timezoneDst"]	["entity驻守的区域属于哪个时区？"]
["headquarters", "grass"]	["什么样的草原产于entity的总部地址？"]
["headquarters", "soil"]	["entity的总部地址的州土壤是什么？"]
["starring", "notableInstruments"]	["哪种乐器参演entity的演员发挥并因此而闻名？"]
["origin", "subdivisionName"]	["entity的发源地的细分名称是什么？"]
["身份", "eventEnd"]	["什么时候entity所在的朝代解散了？"]
["occupation", "sisterNames"]	["什么是entity的职业的姐妹名字？"]
["locale", "mayor"]	["谁是entityEV的所属地点的市长？"]
["youthclubs", "president"]	["谁是entity所属青年俱乐部的总裁？"]
["operator", "subdivisionName"]	["entity的相关运营A方是的细分名称是什么？"]
["operator", "governmentType"]	["entity的相关运营A方是政府类型是什么？"]
["basinCountries", "caption"]	["entity的沿线国家的标识是什么？"]
["birthPlace", "mammal"]	["entity的出生地中濒临灭绝的哺乳动物是什么？"]
["series", "title"]	["什么是entity的名字？"]
["headquarters", "largestmetro"]	["entity的总部地址最大的地铁在哪里？"]
["subdivisionName", "before"]	["谁是entity的上一任？"]
["venue", "governmentType"]	["entity的举办场地政府类型是什么？"]
["location", "tree"]	["什么树大部分种植在entity的位置？"]
["garrison", "subdivisionType"]	["entity驻守的区域的行政级别是什么？"]
["occupation", "stylisticOrigins"]	["entity的职业的风格起源是什么？"]
["occupation", "derivatives"]	["什么是entity的职业的衍生物？"]
["champion", "list3."]	["entity的总冠军为之奋斗的第三支职业球队是什么？"]
["debutteam", "architect"]	["谁是entity的O第一CLPM支球队的建筑师？","谁建立了entity的O第一CLPM支球队？"]
["creator", "placeOfBirth"]	["entity的创造者出生在哪里？"]
["states", "lieutenantGovernor"]	["谁是使用entity的地区现任副州长？"]
["cityofbirth", "birthPlace"]	["entity的出生地出生在哪里？"]
["countryofbirth", "leader"]	["谁是entity的祖国的领导者？"]
["producer", "nationality"]	["entity的制片人的国籍是什么？"]
["influences", "magazine"]	["哪个杂志是entity的人发表在哪？"]
["influences", "associatedActs"]	["谁与entity的人相关联？"]
["主持", "genre"]	["entity的主持人属于哪种类型？"]
["primaryUser", "house"]	["entity的主要用户有什么样的立法机构？"]
["commander", "succession"]	["谁是entity的将领的继承人？"]
["origin", "caption"]	["entity的发源地的标识是什么？"]
["influences", "occupation"]	["entity的人从事的职业是什么？","entity的人的工作是什么？"]
["title", "lcm"]	["谁是entity的标题的新QPR英雄？"]
["nationalteam", "ethnicGroups"]	["entity属于哪个民族？"]
["venue", "callingCode"]	["什么是entity的举办场地中的调用代码？"]
["parent", "location"]	["entity的主公司在哪里？"]
["vicepresident", "spouse"]	["谁是entity的副总统的配偶？"]
["headquarters", "lieutenantGovernor"]	["谁是entity的总部地址现任副州长？"]
["place", "highestpoint"]	["entity的地址的最高点是什么？"]
["referee", "coach"]	["谁是entity的裁判员的现任经理？"]
["wars", "currency"]	["到entity的战争的货币是什么？"]
["workInstitution", "owner"]	["谁是entity的工作机构的所有者？"]
["archipelago", "leaderName"]	["谁是entity的的领导者？"]
["stylisticOrigins", "otherTopics"]	["entity的风格源头属于哪种音乐？"]
["locale", "region"]	["entityEV的所属地点属于哪个列表？","哪个列表包含entityEV的所属地点？"]
["subdivisionName", "postalCode"]	["什么是entity的邮政编码？"]
["platforms", "subsid"]	["entity的发布平台子公司的名称是什么？"]
["deathplace", "governmentType"]	["entity逝世的地方政府类型是什么？"]
["相關團體", "before"]	["谁是entity的相关团体的上一任？"]
["locale", "seat"]	["发现entityEV的所属地点的地方是什么？"]
["placeOfDeath", "northwest"]	["哪个地方位于entity的逝世地址的西北部？"]
["placeOfDeath", "insect"]	["什么样的昆虫是entity的逝世地址特有的？"]
["before", "governmentType"]	["entity的前任政府类型是什么？"]
["經紀公司", "logo"]	["entity的经济公司的标识是什么？"]
["籍貫", "translitLang1Type"]	["什么是entity的籍贯的翻译方案？"]
["籍貫", "bird"]	["哪种鸟类生物居住在entity的籍贯？"]
["birthPlace", "upperhouse"]	["我们用什么名字来称呼entity的出生地的上院？"]
["province", "regionalLanguages"]	["哪种语言是entity中的区域语言？"]
["唱片公司", "regionalLanguages"]	["哪种语言是entity与entity哪家唱片公司中的区域语言？"]
["location", "upperhouse"]	["我们用什么名字来称呼entity的位置的上院？"]
["locationCity", "demonym"]	["我们称之为entity的所在地的人是谁？"]
["before", "ground"]	["entity的前任的主场在哪里？"]
["countryAdminDivisions", "governmentType"]	["entity政府类型是什么？"]
["代表作", "satServ"]	["什么是entity的代表作品的母公司？"]
["after", "label"]	["entity的的标签是什么？"]
["province", "governor"]	["谁是entity的现任州长？"]
["successor", "lowerHouse"]	["什么是entity的一CLPM代产品的下议院？"]
["company", "cableServ"]	["哪个公司entity的运营公司属于？"]
["educate", "chancellor"]	["谁是entity的总理？"]
["awards", "architect"]	["谁是entity获得的奖项的建筑师？","谁建立了entity获得的奖项？"]
["placeOfBirth", "butterfly"]	["在entity的出生地中发现了什么样的蝴蝶？"]
["country", "leaderParty"]	["什么是entity的的领导方？"]
["所在", "translitLang1Type"]	["什么是entity所在的城市的翻译方案？"]
["ground", "location"]	["entity的地址在哪里？"]
["title", "succession"]	["谁是entity的标题的继承人？"]
["nominee", "nationality"]	["entity的提名人的国籍是什么？"]
["areas", "motto"]	["什么是entity的座右铭？"]
["停靠", "subdivisionType"]	["entity的行政级别是什么？"]
["birthPlace", "leaderParty"]	["什么是entity的出生地的领导方？"]
["placeOfBirth", "highestpoint"]	["entity的出生地的最高点是什么？"]
["state", "blank1NameSec"]	["entity所在的州属于什么？"]
["langs", "populationBlank1Title"]	["什么是entity擅长的语言？"]
["製作", "industry"]	["entity的制作方所属的产业类型是什么？"]
["starring", "office"]	["参演entity的演员的职务是什么？"]
["location", "founder"]	["谁是entity的位置的创始人？","谁创立了entity的位置？"]
["territory", "amphibian"]	["什么是IUCN脆弱的物种？青蛙？在entity覆盖的区域？"]
["ground", "region"]	["entity的地址属于哪个列表？","哪个列表包含entity的地址？"]
["namedAfter", "associatedActs"]	["谁与entity的名字相关联？"]
["popplace", "governmentType"]	["entity的主要分布区域政府类型是什么？"]
["母校", "mascot"]	["什么是entity的母校的吉祥物？"]
["countryAdminDivisions", "regionalLanguages"]	["哪种语言是entity中的区域语言？"]
["origin", "tartan"]	["什么是entity的发源地的官方苏格兰格子呢模式？"]
["incumbent", "children"]	["entity的现任孩子的名字是什么？"]
["district", "north"]	["哪个城市位于entity所在的区域的北部？"]
["occupation", "ethnicGroups"]	["entity的职业属于哪个民族？"]
["managerclubs", "asstManager"]	["谁是entity执教的俱乐部的前助理教练？"]
["ground", "caption"]	["entity的地址的标识是什么？"]
["locale", "ethnicGroups"]	["entityEV的所属地点属于哪个民族？"]
["ground", "lowerHouse"]	["什么是entity的地址的下议院？"]
["主持", "associatedActs"]	["谁与entity的主持人相关联？"]
["founder", "primeminister"]	["谁是entity的创始人的首相？"]
["locationCity", "seatType"]	["entity的所在地的行政级别是什么？"]
["ground", "subdivisionName"]	["entity的地址的细分名称是什么？"]
["語言", "leaderTitle"]	["entity使用的语言在哪里作为leaderTitle？"]
["主唱", "ancestry"]	["entity的主唱的家人来自哪里？","entity的主唱的故乡是什么？"]
["notableCommanders", "honorificPrefix"]	["entity的著名指挥官的荣誉称号是什么？"]
["venue", "establishedEvent"]	["什么时候entity的举办场地创建既定事件？"]
["residence", "label"]	["entity的居住地的标签是什么？"]
["居住地", "officialLanguages"]	["entity的居住地的官方语言是什么？"]
["居住地", "caption"]	["entity的居住地的标识是什么？"]
["currentclub", "leaderTitle"]	["entity在哪里作为leaderTitle？"]
["lyrics", "influences"]	["谁影响entity的？"]
["influences", "nationality"]	["entity的人的国籍是什么？"]
["headquarters", "governingBody"]	["entity的总部地址的管理机构是什么？"]
["occupation", "logo"]	["entity的职业的标识是什么？"]
["出生地", "demonym"]	["我们称之为entity的出生地的人是谁？"]
["currentclub", "timezone"]	["entity属于哪个时区？"]
["region", "currency"]	["entity所在的行政区的货币是什么？"]
["debutteam", "before"]	["谁是entity的O第一CLPM支球队的上一任？"]
["currentclub", "asstManager"]	["谁是entity的前助理教练？"]
["location", "seallink"]	["什么是entity的位置的密封链接？"]
["managerclubs", "lcm"]	["谁是entity执教的俱乐部的新QPR英雄？"]
["owner", "label"]	["entity的总裁的标签是什么？"]
["parent", "caption"]	["entity的主公司的标识是什么？"]
["residence", "north"]	["哪个城市位于entity的居住地的北部？"]
["ethnicity", "label"]	["entity的标签是什么？"]
["affiliation", "establishedEvent"]	["什么时候entity的隶属机构创建既定事件？"]
["birthplace", "seallink"]	["什么是entityO第一CLPM支登场的球队的密封链接？"]
["after", "location"]	["entity的在哪里？"]
["主要语言", "agency"]	["哪个机构entity使用的主要语言属于哪个？"]
["products", "genre"]	["entity的产品属于哪种类型？"]
["founder", "placeOfBirth"]	["entity的创始人出生在哪里？"]
["mother", "alongside"]	["谁像entity的母亲一样出名？","谁与entity的母亲同样出名？"]
["ground", "timezoneDst"]	["entity的地址属于哪个时区？"]
["county", "timezone"]	["entity所属的省份属于哪个时区？"]
["basinCountries", "label"]	["entity的沿线国家的标签是什么？"]
["deathplace", "demonym"]	["我们称之为entity逝世的地方的人是谁？"]
["mother", "placeOfDeath"]	["entity的母亲死在哪里？","这是entity的母亲的死亡地点？"]
["commander", "occupation"]	["entity的将领从事的职业是什么？","entity的将领的工作是什么？"]
["subdivisionName", "subdivision"]	["entity分类为哪种细分类型？"]
["beforeElection", "before"]	["谁是entity一CLPM任领导人的上一任？"]
["states", "lowerhouse"]	["我们用什么名字打电话给使用entity的地区的下院？"]
["primeminister", "religion"]	["entity的首相的宗教是什么？"]
["winners", "lcb"]	["谁是entity的冠军队伍的着名前球员？"]
["locationCity", "subdivisionName"]	["entity的所在地的细分名称是什么？"]
["locationCity", "areaCodeType"]	["entity的所在地有哪些类型的区号？"]
["教育程度", "establishedEvent"]	["什么时候entity的毕业学校创建既定事件？"]
["similar", "logo"]	["P与entity相似的车型的标识是什么？"]
["ethnicity", "region"]	["entity属于哪个列表？","哪个列表包含entity？"]
["location", "successor"]	["谁是entity的位置的继承人？"]
["garrison", "governmentType"]	["entity驻守的区域政府类型是什么？"]
["founder", "office"]	["entity的创始人的职务是什么？"]
["garrison", "subdivisionName"]	["entity驻守的区域的细分名称是什么？"]
["constituencyWestminster", "southwest"]	["位于entity的选区西南的是什么？"]
["archipelago", "seat"]	["发现entity的的地方是什么？"]
["label", "ground"]	["entity的标签的主场在哪里？"]
["location", "timezone1Dst"]	["entity的位置属于哪个时区？"]
["followedBy", "label"]	["entity的一CLPM部作品的标签是什么？"]
["deathPlace", "officialReligion"]	["哪一项是entity逝世的地方第一修正案的宗教条款中规定的受宪法保护的权利？"]
["origin", "subdivisionType"]	["entity的发源地的行政级别是什么？"]
["children", "title"]	["什么是entity的子女的名字？"]
["birthplace", "leader"]	["谁是entityO第一CLPM支登场的球队的领导者？"]
["garrison", "settlementType"]	["entity驻守的区域属于哪个地区？"]
["deathPlace", "leaderParty"]	["什么是entity逝世的地方的领导方？"]
["deputy", "party"]	["entity的代理人属于哪一方？"]
["poleTeam", "owner"]	["谁是entity的优胜车队的所有者？"]
["issue", "placeOfBirth"]	["entity的后裔出生在哪里？"]
["region", "grass"]	["什么样的草原产于entity所在的行政区？"]
["籍貫", "subdivisionName"]	["entity的籍贯的细分名称是什么？"]
["referee", "lowerHouse"]	["什么是entity的裁判员的下议院？"]
["location", "grass"]	["什么样的草原产于entity的位置？"]
["deathPlace", "postalCode"]	["什么是entity逝世的地方的邮政编码？"]
["residence", "legislature"]	["什么是entity的居住地的立法机关？"]
["birthplace", "demonym"]	["我们称之为entityO第一CLPM支登场的球队的人是谁？"]
["plat", "supportedPlatforms"]	["entity的发布平台支持哪些平台？"]
["after", "legislature"]	["什么是entity的的立法机关？"]
["deathPlace", "affiliations"]	["entity逝世的地方隶属于什么机构？"]
["出生地", "founder"]	["谁是entity的出生地的创始人？","谁创立了entity的出生地？"]
["cityofbirth", "establishedEvent"]	["什么时候entity的出生地创建既定事件？"]
["locale", "establishedEvent"]	["什么时候entityEV的所属地点创建既定事件？"]
["出生地", "governingBody"]	["entity的出生地的管理机构是什么？"]
["placeOfBirth", "soil"]	["entity的出生地的州土壤是什么？"]
["occupation", "title"]	["什么是entity的职业的名字？"]
["籍貫", "before"]	["谁是entity的籍贯的上一任？"]
["origin", "languages"]	["谁使用entity的发源地的区域语言？"]
["city", "lowerhouse"]	["我们用什么名字打电话给entity的所在城市的下院？"]
["place", "eventEnd"]	["什么时候entity的地址解散了？"]
["genre", "founder"]	["谁是entity的类型的创始人？","谁创立了entity的类型？"]
["start", "leaderTitle"]	["entity的起点站在哪里作为leaderTitle？"]
["locale", "callingCode"]	["什么是entityEV的所属地点中的调用代码？"]
["associatedActs", "spouse"]	["谁是entity的相关艺人的配偶？"]
["stadium", "founder"]	["谁是举办entity的体育场的创始人？","谁创立了举办entity的体育场？"]
["binomialAuthority", "deathPlace"]	["entity的二项式命名法学名的死在哪里？","entity的二项式命名法学名的的死亡地点是什么？"]
["headquarters", "timezone"]	["entity的总部地址属于哪个时区？"]
["manufacturer", "services"]	["什么包含在entity的生产商的服务中？"]
["headquarters", "establishedTitle"]	["哪个法律","行为使entity的总部地址成立？"]
["使用平臺", "developer"]	["谁开发entity的发布平台？","谁是entity的发布平台的开发者？"]
["after", "type"]	["哪种类型是entity的？"]
["電視台", "ethnicGroups"]	["播放entity的电视台属于哪个民族？"]
["discoverySite", "timezone"]	["entity的发现地区属于哪个时区？"]
["operatingSystem", "subsid"]	["entity的操作系统子公司的名称是什么？"]
["state", "areaCodeType"]	["entity所在的州有哪些类型的区号？"]
["placeOfBirth", "amphibian"]	["什么是IUCN脆弱的物种？青蛙？在entity的出生地？"]
["predecessor", "education"]	["entity的前代产品毕业的地方？","entity的前代产品从哪个学校毕业？"]
["author", "keyPeople"]	["谁是entity的原著作者的首席执行官？"]
["placeOfBirth", "blank1NameSec"]	["entity的出生地属于什么？"]
["associatedActs", "nationality"]	["entity的相关艺人的国籍是什么？"]
["manufacturer", "label"]	["entity的生产商的标签是什么？"]
["referee", "nationalteam"]	["哪支球队在20岁之前为entity的裁判员效力？"]
["namedAfter", "successor"]	["谁是entity的名字的继承人？"]
["placeOfDeath", "mammal"]	["entity的逝世地址中濒临灭绝的哺乳动物是什么？"]
["influences", "party"]	["entity的人属于哪一方？"]
["namedAfter", "deathPlace"]	["entity的名字死在哪里？","entity的名字的死亡地点是什么？"]
["designer", "almaMater"]	["entity的设计者从哪里毕业？"]
["namedAfter", "affiliations"]	["entity的名字隶属于什么机构？"]
["appointer", "spouse"]	["谁是entity的任命者的配偶？"]
["almaMater", "title"]	["什么是entity的母校的名字？"]
["birthPlace", "butterfly"]	["在entity的出生地中发现了什么样的蝴蝶？"]
["battles", "lowerHouse"]	["什么是entity参加的战争的下议院？"]
["battles", "sign"]	["entity参加的战争使用什么样的语言？"]
["founder", "issue"]	["谁是entity的创始人的父母？"]
["referee", "president"]	["谁是entity的裁判员的总裁？"]
["placeOfBirth", "bird"]	["哪种鸟类生物居住在entity的出生地？"]
["fam", "languages"]	["谁使用entity的的区域语言？"]
["placeOfBirth", "seat"]	["发现entity的出生地的地方是什么？"]
["operator", "club"]	["哪个俱乐部属于entity的相关运营A方是？"]
["placeOfDeath", "p"]	["如何用汉语拼音拼写entity的逝世地址？","entity的逝世地址的中文拼音是什么？"]
["placeOfBirth", "areaCodeType"]	["entity的出生地有哪些类型的区号？"]
["after", "governor"]	["谁是entity的的现任州长？"]
["areas", "sovereigntyType"]	["什么是entity的主权类型？"]
["locationCity", "settlementType"]	["entity的所在地属于哪个地区？"]
["province", "leaderTitle"]	["entity在哪里作为leaderTitle？"]
["電視台", "founder"]	["谁是播放entity的电视台的创始人？","谁创立了播放entity的电视台？"]
["artist", "placeOfDeath"]	["发布entity的艺人死在哪里？","这是发布entity的艺人的死亡地点？"]
["locale", "lowerhouse"]	["我们用什么名字打电话给entityEV的所属地点的下院？"]
["locale", "seallink"]	["什么是entityEV的所属地点的密封链接？"]
["secondDriver", "birthPlace"]	["entity的亚军车手出生在哪里？"]
["thirdDriver", "before"]	["谁是entity的车手的上一任？"]
["nominee", "almaMater"]	["entity的提名人从哪里毕业？"]
["areas", "governmentType"]	["entity政府类型是什么？"]
["partof", "label"]	["entity的标签是什么？"]
["binomialAuthority", "timezone"]	["entity的二项式命名法学名的属于哪个时区？"]
["country", "leader"]	["谁是entity的的领导者？"]
["locale", "postalCodeType"]	["entityEV的所属地点使用什么类型的邮政编码？"]
["placeOfDeath", "seatType"]	["entity的逝世地址的行政级别是什么？"]
["children", "issue"]	["谁是entity的子女的父母？"]
["afterElection", "leader"]	["谁是entity的胜选者的领导者？"]
["office", "timezone"]	["entity担任的要职属于哪个时区？"]
["deathPlace", "governingBody"]	["entity逝世的地方的管理机构是什么？"]
["播放地區", "timezone"]	["entity属于哪个时区？"]
["placeOfDeath", "grass"]	["什么样的草原产于entity的逝世地址？"]
["主演", "family"]	["谁是entity的演员的家人？","谁是entity的演员的父亲？"]
["region", "blank1NameSec"]	["entity所在的行政区属于什么？"]
["mainStations", "subdivisionName"]	["entity的主要站点的细分名称是什么？"]
["播放地區", "subdivisionType"]	["entity的行政级别是什么？"]
["place", "northwest"]	["哪个地方位于entity的地址的西北部？"]
["mother", "birthPlace"]	["entity的母亲出生在哪里？"]
["locale", "event"]	["哪个文件","事件影响了entityEV的所属地点的灭绝并在欧洲结束了第二次世界大战？"]
["state", "p"]	["如何用汉语拼音拼写entity所在的州？","entity所在的州的中文拼音是什么？"]
["location", "religion"]	["entity的位置的宗教是什么？"]
["moreUsers", "type"]	["哪种类型是使用entity的国家？"]
["nationality", "event"]	["哪个文件","事件影响了entity的国籍的灭绝并在欧洲结束了第二次世界大战？"]
["usedBy", "caption"]	["entity的使用者的标识是什么？"]
["region", "populationBlank1Title"]	["什么是entity所在的行政区？"]
["nationality", "script"]	["什么是entity的国籍的盲文？"]
["演出", "before"]	["谁是出演entity的演员的上一任？"]
["placeOfDeath", "lowerhouse"]	["我们用什么名字打电话给entity的逝世地址的下院？"]
["location", "seatType"]	["entity的位置的行政级别是什么？"]
["secondDriver", "children"]	["entity的亚军车手孩子的名字是什么？"]
["managerclubs", "president"]	["谁是entity执教的俱乐部的总裁？"]
["placeOfBirth", "lowerHouse"]	["什么是entity的出生地的下议院？"]
["placeOfDeath", "leaderParty"]	["什么是entity的逝世地址的领导方？"]
["author", "spouse"]	["谁是entity的原著作者的配偶？"]
["areas", "tartan"]	["什么是entity的官方苏格兰格子呢模式？"]
["managerclubs", "before"]	["谁是entity执教的俱乐部的上一任？"]
["locationCountry", "mammal"]	["entity所在的国家中濒临灭绝的哺乳动物是什么？"]
["operator", "operator"]	["哪个公司entity的相关运营A方是属于？"]
["prevSeason", "starring"]	["谁主演entity的？"]
["placeOfDeath", "timezoneDst"]	["entity的逝世地址属于哪个时区？"]
["champion", "owner"]	["谁是entity的总冠军的所有者？"]
["influences", "deputy"]	["谁是entity的人的部长？"]
["popplace", "region"]	["entity的主要分布区域属于哪个列表？","哪个列表包含entity的主要分布区域？"]
["predecessor", "developer"]	["谁开发entity的前代产品？","谁是entity的前代产品的开发者？"]
["capital", "postalCode"]	["什么是entity的首都的邮政编码？"]
["winners", "manager"]	["谁是entity的冠军队伍的经理？"]
["district", "bishop"]	["谁是entity所在的区域的主教？"]
["citizenship", "label"]	["entity的公民身份的标签是什么？"]
["spouse", "deputy"]	["谁是entity的配偶的部长？"]
["locale", "mammal"]	["entityEV的所属地点中濒临灭绝的哺乳动物是什么？"]
["successor", "manufacturer"]	["什么是entity的一CLPM代产品的制造商？","谁制作了entity的一CLPM代产品？"]
["主持", "ancestry"]	["entity的主持人的家人来自哪里？","entity的主持人的故乡是什么？"]
["seat", "mayor"]	["谁是entity的行政中心的市长？"]
["職業", "instruments"]	["entity的职业使用什么工具？"]
["placeOfDeath", "governingBody"]	["entity的逝世地址的管理机构是什么？"]
["countryAdminDivisions", "northeast"]	["位于entity东北的地方是什么？"]
["consecratedBy", "title"]	["什么是entity的的名字？"]
["branch", "house"]	["entity的有什么样的立法机构？"]
["placeOfDeath", "subdivisionName"]	["entity的逝世地址的细分名称是什么？"]
["before", "deputy"]	["谁是entity的前任的部长？"]
["usedBy", "officialReligion"]	["哪一项是entity的使用者第一修正案的宗教条款中规定的受宪法保护的权利？"]
["lyrics", "children"]	["entity的孩子的名字是什么？"]
["album", "type"]	["哪种类型是entity所属的音乐专辑？"]
["placeOfDeath", "fish"]	["什么是entity的逝世地址中的州鱼？"]
["origin", "script"]	["什么是entity的发源地的盲文？"]
["college", "southeast"]	["哪个城市位于entity所就读的大学的东南部？"]
["college", "north"]	["哪个城市位于entity所就读的大学的北部？"]
["before", "nickname"]	["entity的前任的昵称是什么？"]
["college", "food"]	["entity所就读的大学中食物的无生命徽章是什么？"]
["placeOfBirth", "north"]	["哪个城市位于entity的出生地的北部？"]
["deathPlace", "seallink"]	["什么是entity逝世的地方的密封链接？"]
["allegiance", "currency"]	["entity的货币是什么？"]
["draftTeam", "caption"]	["选秀选中entity的球队的标识是什么？"]
["college", "title"]	["什么是entity所就读的大学的名字？"]
["deathPlace", "tree"]	["什么树大部分种植在entity逝世的地方？"]
["garrison", "insect"]	["什么样的昆虫是entity驻守的区域特有的？"]
["garrison", "reptile"]	["什么是entity驻守的区域的官方国家爬行动物？"]
["owner", "nickname"]	["entity的总裁的昵称是什么？"]
["owner", "mascot"]	["什么是entity的总裁的吉祥物？"]
["cityofbirth", "tree"]	["什么树大部分种植在entity的出生地？"]
["residence", "upperHouse"]	["什么是entity的居住地的上议院？"]
["office", "deputy"]	["谁是entity担任的要职的部长？"]
["allegiance", "upperHouse"]	["什么是entity的上议院？"]
["predecessor", "chancellor"]	["谁是entity的前代产品的总理？"]
["相關團體", "origin"]	["entity的相关团体的起源是什么？"]
["headquarters", "north"]	["哪个城市位于entity的总部地址的北部？"]
["series", "writer"]	["谁写过entity？","谁是entity的作者？"]
["nominee", "spouse"]	["谁是entity的提名人的配偶？"]
["使用平台", "label"]	["entity的使用平台的标签是什么？"]
["現任成員", "title"]	["什么是entity的现任成员的名字？"]
["appointer", "religion"]	["entity的任命者的宗教是什么？"]
["commander", "p"]	["如何用汉语拼音拼写entity的将领？","entity的将领的中文拼音是什么？"]
["身份", "capital"]	["entity所在的朝代的首都在哪里？"]
["placeOfBirth", "insect"]	["什么样的昆虫是entity的出生地特有的？"]
["lyrics", "title"]	["什么是entity的的名字？"]
["placeOfDeath", "mayor"]	["谁是entity的逝世地址的市长？"]
["almaMater", "location"]	["entity的母校在哪里？"]
["managerclubs", "p"]	["如何用汉语拼音拼写entity执教的俱乐部？","entity执教的俱乐部的中文拼音是什么？"]
["incumbent", "event"]	["哪个文件","事件影响了entity的现任的灭绝并在欧洲结束了第二次世界大战？"]
["title", "connectivity"]	["entity的标题的连接性是什么？"]
["birthplace", "north"]	["哪个城市位于entityO第一CLPM支登场的球队的北部？"]
["developer", "author"]	["谁是entity的开发商的作者？"]
["currentclub", "title"]	["什么是entity的名字？"]
["途經地點", "title"]	["什么是entity的途径地点的名字？"]
["father", "before"]	["谁是entity的父亲的上一任？"]
["locale", "tree"]	["什么树大部分种植在entityEV的所属地点？"]
["discoverySite", "leaderName"]	["谁是entity的发现地区的领导者？"]
["discoverySite", "postalCodeType"]	["entity的发现地区使用什么类型的邮政编码？"]
["birthPlace", "translitLang1Type"]	["什么是entity的出生地的翻译方案？"]
["incumbent", "deputy"]	["谁是entity的现任的部长？"]
["areaServed", "translitLang1Type"]	["什么是entity的服务区域的翻译方案？"]
["areaServed", "dialects"]	["entity的服务区域的方言是什么？"]
["教育程度", "agency"]	["哪个机构entity的毕业学校属于哪个？"]
["artist", "influencedBy"]	["谁影响发布entity的艺人？"]
["民族", "region"]	["entity所属的民族属于哪个列表？","哪个列表包含entity所属的民族？"]
["place", "establishedTitle"]	["哪个法律","行为使entity的地址成立？"]
["place", "lowerhouse"]	["我们用什么名字打电话给entity的地址的下院？"]
["place", "fish"]	["什么是entity的地址中的州鱼？"]
["cityofbirth", "reptile"]	["什么是entity的出生地的官方国家爬行动物？"]
["演出", "associatedActs"]	["谁与出演entity的演员相关联？"]
["owner", "officialReligion"]	["哪一项是entity的总裁第一修正案的宗教条款中规定的受宪法保护的权利？"]
["after", "almaMater"]	["entity的从哪里毕业？"]
["before", "starring"]	["谁主演entity的前任？"]
["managerclubs", "lcb"]	["谁是entity执教的俱乐部的着名前球员？"]
["occupation", "keyPeople"]	["谁是entity的职业的首席执行官？"]
["title", "keyPeople"]	["谁是entity的标题的首席执行官？"]
["popplace", "largestmetro"]	["entity的主要分布区域最大的地铁在哪里？"]
["countryAdminDivisions", "establishedEvent"]	["什么时候entity创建既定事件？"]
["products", "ethnicGroups"]	["entity的产品属于哪个民族？"]
["products", "regionalLanguages"]	["哪种语言是entity的产品中的区域语言？"]
["locationCity", "lieutenantGovernor"]	["谁是entity的所在地现任副州长？"]
["basinCountries", "governmentType"]	["entity的沿线国家政府类型是什么？"]
["tenants", "president"]	["谁是entity的承租方的总裁？"]
["时代", "event"]	["哪个文件","事件影响了entity哪个时代的灭绝并在欧洲结束了第二次世界大战？"]
["successor", "subsid"]	["entity的一CLPM代产品子公司的名称是什么？"]
["spouse", "placeOfBirth"]	["entity的配偶出生在哪里？"]
["父親", "placeOfBirth"]	["entity的父亲出生在哪里？"]
["religion", "caption"]	["entity信仰的标识是什么？"]
["designer", "placeOfBirth"]	["entity的设计者出生在哪里？"]
["countryofbirth", "religion"]	["entity的祖国的宗教是什么？"]
["nation", "lowerHouse"]	["什么是entity所属国家的下议院？"]
["studio", "logo"]	["制作entity的工作室的标识是什么？"]
["birthplace", "settlementType"]	["entityO第一CLPM支登场的球队属于哪个地区？"]
["inaugural", "office"]	["就职entity的政客的职务是什么？"]
["currentMembers", "influences"]	["谁影响entity的现任成员？"]
["distributor", "demonym"]	["我们称之为entity的发行商的人是谁？"]
["birthplace", "officialLanguages"]	["entityO第一CLPM支登场的球队的官方语言是什么？"]
