["genre", "subgenres"]	["entity的子类是什么？"]
["birthPlace", "官方文字"]	["entity的出生地的官方文字是什么？","在entity的出生地人们用什么语言交流？","entity的出生地人的交流语言是什么？","entity的出生地人说什么语言？"]
["associatedActs", "唱片公司"]	["entity的相关行为的唱片公司网站是什么？","什么网站是entity的相关行为的唱片公司？"]
["neighboringMunicipalities", "所属区"]	["entity的邻近城市的所属区是什么？","entity的邻近城市所属于哪个区？","entity的邻近城市位于哪个区域？"]
["genre", "instruments"]	["entity歌曲使用的乐器有什么？","entity歌曲用什么乐器演奏？","哪种乐器被用于表演entity？"]
["placeOfBirth", "官方語言"]	["entity的出生地的官方语言是什么？","在entity的出生地人们用什么语言交流？","entity的出生地人的交流语言是什么？","entity的出生地人说什么语言？"]
["country", "國家首都名稱"]	["entity的首都是什么？","哪里是entity的首都？"]
["language", "fam"]	["entity说的语言起源于什么语言？","entity说的语言由什么语言演变而来？"]
["label", "subsid"]	["制作entity的录音标签的子公司包括什么？","什么是制作entity的录音标签的子公司？"]
["placeOfBirth", "國家結構形式"]	["entity的出生地的国家结构形式是什么？","entity的出生地是什么体制的国家？"]
["location", "subdivisionName"]	["entity属于哪个国家？","entity位于哪个国家？"]
["country", "官方文字"]	["entity的官方文字是什么？","在entity人们用什么语言交流？","entity人的交流语言是什么？","entity人说什么语言？"]
["country", "最高點"]	["entity的最高点在哪里？","哪里是entity最高的地方？"]
["language", "states"]	["使用entity说的语言的地区有哪些？","哪里使用entity说的语言语言？"]
["draftTeam", "coach"]	["entity的选秀团队的教练是谁？","谁执教entity的选秀团队？"]
["birthPlace", "政治体制"]	["entity的出生地的政治体制是什么？","entity的出生地采用什么政治体制？"]
["draftTeam", "ceo"]	["entity的选秀团队的Centity的选秀团队O是谁？","entity的选秀团队的首席执行官是谁？","谁是entity的选秀团队的Centity的选秀团队O?"]
["managerclubs", "shirtsponsors"]	["entity管理的俱乐部的球衣供应商是谁？","谁为entity管理的俱乐部提供球衣？"]
["residence", "timezoneDst"]	["entity的住所使用的时区是什么？","entity的住所按哪个时区记时？"]
["placeOfBirth", "最高點"]	["entity的出生地的最高点在哪里？","哪里是entity的出生地最高的地方？"]
["locale", "capital"]	["entity的省会是哪里？","entity的省会叫什么？","哪里是entity的省会？"]
["placeOfDeath", "主要宗教"]	["entity的死亡地点的主要宗教是什么？","什么宗教在entity的死亡地点属于主流？"]
["artist", "代表作"]	["entity的艺术家的代表作是什么？","哪个作品是entity的艺术家的代表作？"]
["placeOfBirth", "國花"]	["entity的出生地的国花是什么？","哪种花是entity的出生地的国花？"]
["birthPlace", "最大湖泊"]	["entity的出生地的最大湖泊是什么湖？","哪个湖是entity的出生地中最大的湖泊？"]
["genre", "derivatives"]	["entity的衍生类型是什么？"]
["artist", "currentMembers"]	["entity的艺术家的现有成员是谁？","谁现在在entity的艺术家中？"]
["country", "最大城市名稱"]	["entity的最大的城市的名称是什么？","哪座城市是entity中最大的城市？"]
["locationCountry", "貨幣單位"]	["entity所在的国家的货币单位是什么？","entity所在的国家使用什么货币？","哪种货币在entity所在的国家流通？"]
["birthPlace", "最大城市名稱"]	["entity的出生地的最大的城市的名称是什么？","哪座城市是entity的出生地中最大的城市？"]
["spouse", "successor"]	["entity的配偶的后继是什么？"]
["allegiance", "currency"]	["entity的效忠中使用的货币是什么？","什么货币在entity的效忠中被使用？","entity的效忠中流通的货币是什么？"]
["subdivisionName", "政治制度二"]	["entity的国家政权是什么结构？"]
["clubs", "name"]	["entity所在的俱乐部的繁体形式是什么？","entity所在的俱乐部的繁体怎么写？"]
["managerclubs", "ground"]	["entity管理的俱乐部的主场在哪里？"]
["placeOfBirth", "貨幣單位"]	["entity的出生地的货币单位是什么？","entity的出生地使用什么货币？","哪种货币在entity的出生地流通？"]
["placeOfBirth", "subdivisionName"]	["entity的出生地属于哪个国家？","entity的出生地位于哪个国家？"]
["placeOfBirth", "中央政府所在地"]	["entity的出生地的中央政府所在地是哪里？"]
["birthDate", "最大城市名稱"]	["entity的最大的城市的名称是什么？","哪座城市是entity中最大的城市？"]
["format", "instruments"]	["entity的格式歌曲使用的乐器有什么？","entity的格式歌曲用什么乐器演奏？","哪种乐器被用于表演entity的格式？"]
["location", "governor"]	["entity的省长是谁？","谁是entity的总督？"]
["platforms", "generation"]	["entity所处的平台处于哪一世代？"]
["artist", "origin"]	["entity的艺术家来自哪里？","entity的艺术家的家乡在哪里？"]
["deathPlace", "subdivisionType"]	["entity的死亡地点的划分种类是什么？"]
["placeOfDeath", "subdivisionType"]	["entity的死亡地点的划分种类是什么？"]
["developer", "subsid"]	["entity的开发者的子公司包括什么？","什么是entity的开发者的子公司？"]
["origin", "中央銀行"]	["entity的中央银行是什么？","什么是entity的中央银行？"]
["birthPlace", "曆法"]	["entity的出生地的历法是什么？","entity的出生地地区采用什么历法？"]
["placeOfBirth", "west"]	["entity的出生地的西部城市是什么？","哪个城市位于entity的出生地西部？"]
["placeOfBirth", "southeast"]	["entity的出生地的东南部是哪个城市？","哪个城市位于entity的出生地的东南部？"]
["placeOfBirth", "northwest"]	["entity的出生地的西北部是哪个城市？","哪个城市位于entity的出生地的西北部？"]
["placeOfDeath", "timezone"]	["entity的死亡地点使用的时区是什么？","entity的死亡地点按哪个时区记时？"]
["shortDescription", "政治制度二"]	["entity的简短描述的国家政权是什么结构？"]
["placeOfBirth", "timezone"]	["entity的出生地使用的时区是什么？","entity的出生地按哪个时区记时？"]
["placeOfDeath", "官方文字"]	["entity的死亡地点的官方文字是什么？","在entity的死亡地点人们用什么语言交流？","entity的死亡地点人的交流语言是什么？","entity的死亡地点人说什么语言？"]
["nationalteam", "stadium"]	["entity的国家队的体育馆是什么？","哪里是entity的国家队的体育馆？"]
["managerclubs", "name"]	["entity管理的俱乐部的繁体形式是什么？","entity管理的俱乐部的繁体怎么写？"]
["location", "東"]	["entity东部的海洋是什么？","什么海位于entity东部？"]
["platforms", "manufacturer"]	["entity所处的平台的制造商是谁？","entity所处的平台由谁制造的？","哪个厂家制造的entity所处的平台？"]
["team", "colors"]	["entity所在的团队的颜色是什么？","什么颜色代表entity所在的团队？"]
["allegiance", "主要節日"]	["entity的效忠的主要节日是什么？","什么节日是entity的效忠的主要节日？"]
["city", "subdivisionName"]	["entity所在的城市属于哪个国家？","entity所在的城市位于哪个国家？"]
["nationality", "官方語言"]	["entity的国籍的官方语言是什么？","在entity的国籍人们用什么语言交流？","entity的国籍人的交流语言是什么？","entity的国籍人说什么语言？"]
["publisher", "products"]	["entity的出版商的产品都有什么？"]
["birthPlace", "主要節日"]	["entity的出生地的主要节日是什么？","什么节日是entity的出生地的主要节日？"]
["designer", "keyPeople"]	["entity的设计师的最重要的职务是什么？","entity的设计师中最高职位是什么？"]
["genre", "fusiongenres"]	["entity的融合形式是什么？","融合过的entity形式是什么？"]
["deathPlace", "timezoneDst"]	["entity的死亡地点使用的时区是什么？","entity的死亡地点按哪个时区记时？"]
["birthPlace", "subdivisionName"]	["entity的出生地属于哪个国家？","entity的出生地位于哪个国家？"]
["headquarters", "timezone"]	["entity的总部使用的时区是什么？","entity的总部按哪个时区记时？"]
["headquarters", "主要宗教"]	["entity的总部的主要宗教是什么？","什么宗教在entity的总部属于主流？"]
["origin", "曆法"]	["entity的历法是什么？","entity地区采用什么历法？"]
["artist", "音樂類型"]	["entity的艺术家创作的音乐类型是什么？","entity的艺术家的音乐属于什么类型？"]
["shireDistrict", "subdivisionName"]	["entity的shireistrict属于哪个国家？","entity的shireistrict位于哪个国家？"]
["shireDistrict", "timezone"]	["entity的shireistrict使用的时区是什么？","entity的shireistrict按哪个时区记时？"]
["citizenship", "政治制度二"]	["entity的公民身份的国家政权是什么结构？"]
["label", "products"]	["制作entity的录音标签的产品都有什么？"]
["placeOfBirth", "最大湖泊"]	["entity的出生地的最大湖泊是什么湖？","哪个湖是entity的出生地中最大的湖泊？"]
["origin", "主要宗教"]	["entity的主要宗教是什么？","什么宗教在entity属于主流？"]
["placeOfBirth", "最大城市名稱"]	["entity的出生地的最大的城市的名称是什么？","哪座城市是entity的出生地中最大的城市？"]
["placeOfBirth", "西"]	["entity的出生地西部的海洋是什么？","什么海位于entity的出生地西部？"]
["starring", "before"]	["一CLPM个主演entity的演员的上一位是什么？"]
["youthclubs", "league"]	["entity参与的联赛叫什么名字？","entity在哪个联赛中参加比赛？"]
["alliances", "writers"]	["entity的联盟之一的作者是谁？","是谁创作了entity的联盟之一？","谁写的entity的联盟之一？","entity的联盟之一是谁的作品？"]
["origin", "民族"]	["entity的民族有哪些？","entity包含哪些民族？"]
["origin", "西南"]	["entity西南部的海洋是什么？","什么海位于entity西南部？"]
["birthPlace", "timezone"]	["entity的出生地使用的时区是什么？","entity的出生地按哪个时区记时？"]
["team", "manager"]	["entity所在的团队的经理是谁？","谁是entity所在的团队的经理？","谁经营管理entity所在的团队？"]
["starring", "children"]	["一CLPM个主演entity的演员的孩子是谁？","谁是一CLPM个主演entity的演员的孩子？","一CLPM个主演entity的演员的孩子叫什么？"]
["almaMater", "affiliations"]	["entity的母校的附属机构是什么？"]
["branch", "commander"]	["entity的一CLPM个分支的指挥官是谁？","entity的一CLPM个分支受谁的指挥？","谁指挥entity的一CLPM个分支？"]
["artist", "genre"]	["entity的艺术家的演唱类型是什么?","entity的艺术家演唱什么类型的音乐？"]
["city", "postalCode"]	["entity所在的城市的邮政编码是什么?"]
["country", "民族"]	["entity的民族有哪些？","entity包含哪些民族？"]
["deathPlace", "政治制度三"]	["entity的死亡地点的政治制度是什么？","entity的死亡地点采用什么制度治国？","什么政治制度被entity的死亡地点所采用？"]
["birthPlace", "senators"]	["entity的出生地的参议员是谁？"]
["president", "vicepresident"]	["entity的总裁的副总统是谁?","谁是entity的总裁的副总统？"]
["placeOfBirth", "postalCodeType"]	["entity的出生地的邮政编码是什么？"]
["placeOfBirth", "主要節日"]	["entity的出生地的主要节日是什么？","什么节日是entity的出生地的主要节日？"]
["genre", "stylisticOrigins"]	["entity风格的起源是什么？","entity起源于什么类型的歌曲？"]
["platforms", "type"]	["entity所处的平台的职业是什么？"]
["country", "東"]	["entity东部的海洋是什么？","什么海位于entity东部？"]
["placeOfDeath", "主要節日"]	["entity的死亡地点的主要节日是什么？","什么节日是entity的死亡地点的主要节日？"]
["deathPlace", "國家外文語言"]	["entity的死亡地点的国家语言是什么？","entity的死亡地点使用什么语言？","在entity的死亡地点中人们用什么语言交流?"]
["nationalteam", "club"]	["entity的国家队属于什么俱乐部？","entity的国家队是哪个俱乐部下的球队？"]
["placeOfBirth", "國家憲法"]	["entity的出生地的国家宪法叫什么？","哪部法律是entity的出生地的国家宪法？"]
["birthPlace", "province"]	["entity的出生地位于哪个省？","哪个省包含城市entity的出生地？","entity的出生地处于哪个省中？"]
["format", "derivatives"]	["entity的格式的衍生类型是什么？"]
["subdivisionName", "最高點"]	["entity的最高点在哪里？","哪里是entity最高的地方？"]
["location", "官方語言"]	["entity的官方语言是什么？","在entity人们用什么语言交流？","entity人的交流语言是什么？","entity人说什么语言？"]
["nationalteam", "name"]	["entity的国家队的繁体形式是什么？","entity的国家队的繁体怎么写？"]
["state", "timezone"]	["entity所属的州使用的时区是什么？","entity所属的州按哪个时区记时？"]
["birthPlace", "中央銀行"]	["entity的出生地的中央银行是什么？","什么是entity的出生地的中央银行？"]
["placeOfBirth", "中央銀行"]	["entity的出生地的中央银行是什么？","什么是entity的出生地的中央银行？"]
["location", "國家結構形式"]	["entity的国家结构形式是什么？","entity是什么体制的国家？"]
["label", "parent"]	["制作entity的录音标签的前身是什么？","制作entity的录音标签由什么演变而来？"]
["country", "最大行政區名稱"]	["entity的最大行政区名称是什么？"]
["location", "立國日期"]	["entity的建国日期是什么？"]
["birthPlace", "leaderParty"]	["entity的出生地的领导政党是什么？","entity的出生地受什么政党领导？","哪个政党领导entity的出生地？"]
["almaMater", "nickname"]	["entity的母校的绰号叫什么？","entity的母校又被称为什么？","entity的母校的另外的名字是什么？"]
["placeOfBirth", "南"]	["entity的出生地南部水域是什么？","哪个水域位于entity的出生地南部？"]
["writer", "occupation"]	["entity的作家的职业是什么？"]
["party", "ideology"]	["entity所属的政党的意识形态是什么？"]
["birthPlace", "leaderName"]	["entity的出生地的领导者是谁？","entity的出生地的市长的名字是什么？","谁是entity的出生地的市长？"]
["city", "senators"]	["entity所在的城市的参议员是谁？"]
["placeOfBirth", "國家政權"]	["entity的出生地的国家政权是什么结构？"]
["deathPlace", "最大湖泊"]	["entity的死亡地点的最大湖泊是什么湖？","哪个湖是entity的死亡地点中最大的湖泊？"]
["placeOfBirth", "capital"]	["entity的出生地的省会是哪里？","entity的出生地的省会叫什么？","哪里是entity的出生地的省会？"]
["subdivisionName", "貨幣單位"]	["entity的货币单位是什么？","entity使用什么货币？","哪种货币在entity流通？"]
["country", "國家憲法"]	["entity的国家宪法叫什么？","哪部法律是entity的国家宪法？"]
["birthPlace", "道路通行方向"]	["entity的出生地的道路通行方向是什么？","在entity的出生地人们倾向于靠什么方向通行？"]
["battles", "commander"]	["entity加入的战斗的指挥官是谁？","entity加入的战斗受谁的指挥？","谁指挥entity加入的战斗？"]
["placeOfBirth", "西南"]	["entity的出生地西南部的海洋是什么？","什么海位于entity的出生地西南部？"]
["platforms", "connectivity"]	["entity所处的平台通过什么联网？","entity所处的平台的互联方式是什么？"]
["origin", "西"]	["entity西部的海洋是什么？","什么海位于entity西部？"]
["appointer", "predecessor"]	["entity的任命的前身是什么？"]
["birthPlace", "民族"]	["entity的出生地的民族有哪些？","entity的出生地包含哪些民族？"]
["deathPlace", "最大行政區名稱"]	["entity的死亡地点的最大行政区名称是什么？"]
["cityServed", "法律體系"]	["entity的服务的法律体系是什么？","什么法律体系被entity的服务使用？"]
["southwest", "subdivisionName"]	["entity的西南属于哪个国家？","entity的西南位于哪个国家？"]
["location", "中央銀行"]	["entity的中央银行是什么？","什么是entity的中央银行？"]
["deathPlace", "國家政權"]	["entity的死亡地点的国家政权是什么结构？"]
["predecessor", "after"]	["entity的前身的下一位是什么？"]
["placeOfBirth", "viceroy"]	["entity的出生地的总督是谁？","谁是entity的出生地的总督？","entity的出生地的最高行政长官是谁？","谁是entity的出生地的最高行政长官？"]
["subdivisionName", "西"]	["entity西部的海洋是什么？","什么海位于entity西部？"]
["writer", "instrument"]	["entity的作家演奏的乐器是什么？","entity的作家表演什么乐器？"]
["locationCity", "subdivisionName"]	["entity所在的城市属于哪个国家？","entity所在的城市位于哪个国家？"]
["manufacturer", "divisions"]	["entity的制造商的子公司有什么？","哪个公司是entity的制造商的子公司？"]
["country", "國家結構形式"]	["entity的国家结构形式是什么？","entity是什么体制的国家？"]
["country", "主要節日"]	["entity的主要节日是什么？","什么节日是entity的主要节日？"]
["region", "viceroy"]	["entity所属的地区的总督是谁？","谁是entity所属的地区的总督？","entity所属的地区的最高行政长官是谁？","谁是entity所属的地区的最高行政长官？"]
["champions", "name"]	["entity的冠军的繁体形式是什么？","entity的冠军的繁体怎么写？"]
["mostChamps", "name"]	["entityA最多冠军的人的繁体形式是什么？","entityA最多冠军的人的繁体怎么写？"]
["publisher", "genre"]	["entity的出版商的演唱类型是什么?","entity的出版商演唱什么类型的音乐？"]
["birthPlace", "国家政权"]	["entity的出生地的国家政权是什么？"]
["starring", "職業"]	["一CLPM个主演entity的演员的职业是什么？","一CLPM个主演entity的演员是做什么的？"]
["birthPlace", "官方語言"]	["entity的出生地的官方语言是什么？","在entity的出生地人们用什么语言交流？","entity的出生地人的交流语言是什么？","entity的出生地人说什么语言？"]
["location", "premierparty"]	["entity的总理党是什么？","entity的首要党派是什么？哪个党派在entity中处于首要位置？"]
["birthPlace", "leader"]	["entity的出生地的领导人是谁？","谁领导entity的出生地？","谁是entity的出生地的领导者？"]
["after", "successor"]	["entity的后继是什么？"]
["birthPlace", "國家憲法"]	["entity的出生地的国家宪法叫什么？","哪部法律是entity的出生地的国家宪法？"]
["clubs", "league"]	["entity所在的俱乐部参与的联赛叫什么名字？","entity所在的俱乐部在哪个联赛中参加比赛？"]
["workplaces", "affiliations"]	["entity的工作地点的附属机构是什么？"]
["music", "代表作"]	["制造entity的人的代表作是什么？","哪个作品是制造entity的人的代表作？"]
["music", "語言"]	["制造entity的人使用的语言是什么？","制造entity的人用什么语言交流？"]
["headquarters", "timezoneDst"]	["entity的总部使用的时区是什么？","entity的总部按哪个时区记时？"]
["location", "governmentType"]	["entity的市政管理组织模式是什么？","市政管理在entity是如何组织的？"]
["nationality", "貨幣單位"]	["entity的国籍的货币单位是什么？","entity的国籍使用什么货币？","哪种货币在entity的国籍流通？"]
["locationCountry", "官方文字"]	["entity所在的国家的官方文字是什么？","在entity所在的国家人们用什么语言交流？","entity所在的国家人的交流语言是什么？","entity所在的国家人说什么语言？"]
["residence", "東"]	["entity的住所东部的海洋是什么？","什么海位于entity的住所东部？"]
["locationCity", "leaderName"]	["entity所在的城市的领导者是谁？","entity所在的城市的市长的名字是什么？","谁是entity所在的城市的市长？"]
["locationCountry", "中央銀行"]	["entity所在的国家的中央银行是什么？","什么是entity所在的国家的中央银行？"]
["birthPlace", "deputy"]	["entity的出生地的代表是什么？","谁可以代表entity的出生地？"]
["influences", "influenced"]	["entity的影响受影响于什么？","entity的影响受到什么的影响？"]
["areaServed", "立國事件"]	["entity服务的区域的立国事件是什么？","什么事件标志着entity服务的区域成立？"]
["subdivisionName", "data"]	["entity的发生时间是什么时候？","事件entity在何时发生？","什么时候发生的事件entity？"]
["nationality", "最長河流"]	["entity的国籍的最长河流叫什么名字？","哪条河是entity的国籍中最长的河流？"]
["deathPlace", "timezone"]	["entity的死亡地点使用的时区是什么？","entity的死亡地点按哪个时区记时？"]
["placeOfBirth", "法律體系"]	["entity的出生地的法律体系是什么？","什么法律体系被entity的出生地使用？"]
["placeOfDeath", "deputy"]	["entity的死亡地点的代表是什么？","谁可以代表entity的死亡地点？"]
["billed", "timezone"]	["entity使用的时区是什么？","entity按哪个时区记时？"]
["manufacturer", "industry"]	["entity的制造商属于什么产业？"]
["location", "officiallang"]	["entity的官方语言是什么？"]
["county", "subdivisionName"]	["有entity属于哪个国家？","有entity位于哪个国家？"]
["location", "貨幣單位"]	["entity的货币单位是什么？","entity使用什么货币？","哪种货币在entity流通？"]
["parents", "genre"]	["entity的父母的演唱类型是什么?","entity的父母演唱什么类型的音乐？"]
["birthPlace", "legislature"]	["entity的出生地的立法机构是什么？"]
["associatedActs", "currentMembers"]	["entity的相关行为的现有成员是谁？","谁现在在entity的相关行为中？"]
["title", "associatedActs"]	["与entity的标题有关系的演员是谁？"]
["location", "立國事件"]	["entity的立国事件是什么？","什么事件标志着entity成立？"]
["country", "中央銀行"]	["entity的中央银行是什么？","什么是entity的中央银行？"]
["country", "主要宗教"]	["entity的主要宗教是什么？","什么宗教在entity属于主流？"]
["birthPlace", "國家結構形式"]	["entity的出生地的国家结构形式是什么？","entity的出生地是什么体制的国家？"]
["location", "location"]	["entity位于哪里？entity的位置是什么？"]
["branch", "identificationSymbol"]	["entity的一CLPM个分支的标志符号是多少？"]
["location", "主要宗教"]	["entity的主要宗教是什么？","什么宗教在entity属于主流？"]
["programmingLanguage", "influenced"]	["entity编写的编程语言受影响于什么？","entity编写的编程语言受到什么的影响？"]
["artist", "associatedActs"]	["与entity的艺术家有关系的演员是谁？"]
["placeOfBirth", "國家首都名稱"]	["entity的出生地的首都是什么？","哪里是entity的出生地的首都？"]
["birthPlace", "國家首都名稱"]	["entity的出生地的首都是什么？","哪里是entity的出生地的首都？"]
["birthPlace", "mapCaption"]	["entity的出生地的地图说明是什么？","entity的出生地在地图上的说明是什么？","地图上关于entity的出生地的描述是什么？"]
["location", "貨幣代碼"]	["entity的货币代码是什么?",""]
["location", "leaderName"]	["entity的领导者是谁？","entity的市长的名字是什么？","谁是entity的市长？"]
["workInstitutions", "data"]	["entity工作的机构的发生时间是什么时候？","事件entity工作的机构在何时发生？","什么时候发生的事件entity工作的机构？"]
["placeOfBirth", "senators"]	["entity的出生地的参议员是谁？"]
["placeOfBirth", "官方文字"]	["entity的出生地的官方文字是什么？","在entity的出生地人们用什么语言交流？","entity的出生地人的交流语言是什么？","entity的出生地人说什么语言？"]
["location", "subdivisionType"]	["entity的划分种类是什么？"]
["placeOfDeath", "民族"]	["entity的死亡地点的民族有哪些？","entity的死亡地点包含哪些民族？"]
["associatedActs", "genre"]	["entity的相关行为的演唱类型是什么?","entity的相关行为演唱什么类型的音乐？"]
["name", "position"]	["entity的名字的位置是什么？","entity的名字在比赛中打什么位置？"]
["almaMater", "type"]	["entity的母校的职业是什么？"]
["starring", "唱片公司"]	["一CLPM个主演entity的演员的唱片公司网站是什么？","什么网站是一CLPM个主演entity的演员的唱片公司？"]
["country", "西南"]	["entity西南部的海洋是什么？","什么海位于entity西南部？"]
["episodeList", "writtenby"]	["entity所在的剧集列表由谁创作？","谁写的entity所在的剧集列表？","entity所在的剧集列表是谁的作品？"]
["birthPlace", "subdivisionType"]	["entity的出生地的划分种类是什么？"]
["writer", "associatedActs"]	["与entity的作家有关系的演员是谁？"]
["writer", "genre"]	["entity的作家的演唱类型是什么?","entity的作家演唱什么类型的音乐？"]
["subdivisionName", "官方文字"]	["entity的官方文字是什么？","在entity人们用什么语言交流？","entity人的交流语言是什么？","entity人说什么语言？"]
["placeOfBirth", "mapCaption"]	["entity的出生地的地图说明是什么？","entity的出生地在地图上的说明是什么？","地图上关于entity的出生地的描述是什么？"]
["placeOfBirth", "曆法"]	["entity的出生地的历法是什么？","entity的出生地地区采用什么历法？"]
["province", "premierparty"]	["entity所在的省份的总理党是什么？","entity所在的省份的首要党派是什么？哪个党派在entity所在的省份中处于首要位置？"]
["location", "官方文字"]	["entity的官方文字是什么？","在entity人们用什么语言交流？","entity人的交流语言是什么？","entity人说什么语言？"]
["headquarters", "最大行政區名稱"]	["entity的总部的最大行政区名称是什么？"]
["birthPlace", "東"]	["entity的出生地东部的海洋是什么？","什么海位于entity的出生地东部？"]
["birthPlace", "postalcodeprefix"]	["entity的出生地的邮政编码前缀是什么？"]
["distributor", "parent"]	["entity的经销商的前身是什么？","entity的经销商由什么演变而来？"]
["party", "european"]	["entity所属的政党在欧洲的形式是什么？","欧洲的entity所属的政党是什么？"]
["birthPlace", "postalCode"]	["entity的出生地的邮政编码是什么?"]
["country", "中央政府所在地"]	["entity的中央政府所在地是哪里？"]
["manufacturer", "keyPeople"]	["entity的制造商的最重要的职务是什么？","entity的制造商中最高职位是什么？"]
["publisher", "subsid"]	["entity的出版商的子公司包括什么？","什么是entity的出版商的子公司？"]
["deathPlace", "senators"]	["entity的死亡地点的参议员是谁？"]
["country", "國家政權"]	["entity的国家政权是什么结构？"]
["platforms", "sourceModel"]	["entity所处的平台的代码模型是什么？"]
["platforms", "media"]	["entity所处的平台的媒体是什么？","entity所处的平台采用什么方式传媒？","entity所处的平台的传媒方式是什么？"]
["birthPlace", "國家代碼"]	["entity的出生地的国家代码是什么？"]
["publisher", "industry"]	["entity的出版商属于什么产业？"]
["party", "position"]	["entity所属的政党的位置是什么？","entity所属的政党在比赛中打什么位置？"]
["placeOfBirth", "道路通行方向"]	["entity的出生地的道路通行方向是什么？","在entity的出生地人们倾向于靠什么方向通行？"]
["location", "南"]	["entity南部水域是什么？","哪个水域位于entity南部？"]
["location", "最大城市名稱"]	["entity的最大的城市的名称是什么？","哪座城市是entity中最大的城市？"]
["location", "法律體系"]	["entity的法律体系是什么？","什么法律体系被entity使用？"]
["location", "south"]	["entity的南部是哪个城市？","哪个城市位于entity的南部？"]
["stadium", "tenants"]	["entity发生的体育场被哪个球队所使用？","哪个球队的主场在entity发生的体育场？","entity发生的体育场是哪个球队的主场？"]
["leader", "predecessor"]	["entity的领导者的前身是什么？"]
["clubs", "ground"]	["entity所在的俱乐部的主场在哪里？"]
["headquarters", "capital"]	["entity的总部的省会是哪里？","entity的总部的省会叫什么？","哪里是entity的总部的省会？"]
["after", "influenced"]	["entity受影响于什么？","entity受到什么的影响？"]
["subdivisionName", "官方語言"]	["entity的官方语言是什么？","在entity人们用什么语言交流？","entity人的交流语言是什么？","entity人说什么语言？"]
["placeOfBirth", "largestmetro"]	["entity的出生地的地铁在哪个区域？"]
["nationality", "region"]	["entity的国籍所在区域是哪里？",""]
["location", "governingBody"]	["entity的执政团体是谁？","entity的主管部门是什么？","哪个部门主管entity？"]
["successor", "placeOfBirth"]	["entity的接班人的出生地是哪里？","entity的接班人在那里出生？"]
["origin", "國家代碼"]	["entity的国家代码是什么？"]
["headquarters", "曆法"]	["entity的总部的历法是什么？","entity的总部地区采用什么历法？"]
["citizenship", "國家結構形式"]	["entity的公民身份的国家结构形式是什么？","entity的公民身份是什么体制的国家？"]
["placeOfBirth", "貨幣代碼"]	["entity的出生地的货币代码是什么?",""]
["birthPlace", "西北"]	["entity的出生地西南部的海洋是什么？","什么海位于entity的出生地西南部？"]
["placeOfDeath", "senators"]	["entity的死亡地点的参议员是谁？"]
["nationality", "最大行政區名稱"]	["entity的国籍的最大行政区名称是什么？"]
["education", "type"]	["entity参加的大学的职业是什么？"]
["location", "southeast"]	["entity的东南部是哪个城市？","哪个城市位于entity的东南部？"]
["location", "國家首都名稱"]	["entity的首都是什么？","哪里是entity的首都？"]
["location", "senators"]	["entity的参议员是谁？"]
["country", "官方語言"]	["entity的官方语言是什么？","在entity人们用什么语言交流？","entity人的交流语言是什么？","entity人说什么语言？"]
["origin", "type"]	["entity的职业是什么？"]
["partof", "place"]	["entity的一部分的地点在哪里？","哪里有entity的一部分？","entity的一部分位于什么地方？","entity的一部分在哪里？"]
["location", "政治制度"]	["entity的政治制度是什么？","entity采用什么制度治国？","什么政治制度被entity所采用？"]
["location", "主要节日"]	["entity的主要节日是什么？","什么节日是entity的主要节日？"]
["starring", "placeOfBirth"]	["一CLPM个主演entity的演员的出生地是哪里？","一CLPM个主演entity的演员在那里出生？"]
["subdivisionName", "法律體系"]	["entity的法律体系是什么？","什么法律体系被entity使用？"]
["subdivisionName", "國家結構形式"]	["entity的国家结构形式是什么？","entity是什么体制的国家？"]
["subdivisionName", "timeZone"]	["entity使用的时区是什么？","entity按哪个时区记时？"]
["network", "subsid"]	["entity的子公司包括什么？","什么是entity的子公司？"]
["clubs", "chairman"]	["entity所在的俱乐部的主席是谁？","谁是entity所在的俱乐部的主席？"]
["subdivisionName", "最大行政區名稱"]	["entity的最大行政区名称是什么？"]
["battles", "place"]	["entity加入的战斗的地点在哪里？","哪里有entity加入的战斗？","entity加入的战斗位于什么地方？","entity加入的战斗在哪里？"]
["deathPlace", "governingBody"]	["entity的死亡地点的执政团体是谁？","entity的死亡地点的主管部门是什么？","哪个部门主管entity的死亡地点？"]
["hostCity", "國家結構形式"]	["entity的主办城市的国家结构形式是什么？","entity的主办城市是什么体制的国家？"]
["location", "主要節日"]	["entity的主要节日是什么？","什么节日是entity的主要节日？"]
["stadium", "location"]	["entity发生的体育场位于哪里？entity发生的体育场的位置是什么？"]
["hostCity", "南"]	["entity的主办城市南部水域是什么？","哪个水域位于entity的主办城市南部？"]
["birthPlace", "國家外文語言"]	["entity的出生地的国家语言是什么？","entity的出生地使用什么语言？","在entity的出生地中人们用什么语言交流?"]
["nationality", "曆法"]	["entity的国籍的历法是什么？","entity的国籍地区采用什么历法？"]
["placeOfDeath", "國家結構形式"]	["entity的死亡地点的国家结构形式是什么？","entity的死亡地点是什么体制的国家？"]
["monarch", "as"]	["entity的君主是谁？","entity的君主的职务是什么？","entity的君主的身份是什么？"]
["monarch", "after"]	["entity的君主的下一位是什么？"]
["honorificSuffix", "lower"]	["entity的敬语后缀的下一个等级勋章是什么？","什么勋章位于entity的敬语后缀的下一个等级？","比entity的敬语后缀等级低一等的勋章是什么？"]
["label", "country"]	["制作entity的录音标签在哪个国家？","制作entity的录音标签属于哪个国家？","制作entity的录音标签位于哪个国家？"]
["unitaryWales", "subdivisionName"]	["entity的单一威尔士属于哪个国家？","entity的单一威尔士位于哪个国家？"]
["stadium", "leaderName"]	["entity发生的体育场的领导者是谁？","entity发生的体育场的市长的名字是什么？","谁是entity发生的体育场的市长？"]
["headquarters", "國家憲法"]	["entity的总部的国家宪法叫什么？","哪部法律是entity的总部的国家宪法？"]
["area", "國家首都名稱"]	["entity所在的区域的首都是什么？","哪里是entity所在的区域的首都？"]
["label", "founder"]	["制作entity的录音标签的创办者是谁？","谁创立了制作entity的录音标签？","制作entity的录音标签由谁建立？"]
["primeminister", "almaMater"]	["entity的总理的母校是哪？","哪个学校是entity的总理的母校？"]
["residence", "timezone"]	["entity的住所使用的时区是什么？","entity的住所按哪个时区记时？"]
["location", "國家政權"]	["entity的国家政权是什么结构？"]
["placeOfBirth", "region"]	["entity的出生地所在区域是哪里？",""]
["country", "曆法"]	["entity的历法是什么？","entity地区采用什么历法？"]
["placeOfBirth", "governor"]	["entity的出生地的省长是谁？","谁是entity的出生地的总督？"]
["placeOfBirth", "東"]	["entity的出生地东部的海洋是什么？","什么海位于entity的出生地东部？"]
["shipBuilder", "最大城市名稱"]	["entity的建设者的最大的城市的名称是什么？","哪座城市是entity的建设者中最大的城市？"]
["city", "subdivisionType"]	["entity所在的城市的划分种类是什么？"]
["state", "capital"]	["entity所属的州的省会是哪里？","entity所属的州的省会叫什么？","哪里是entity所属的州的省会？"]
["placeOfBirth", "政治制度三"]	["entity的出生地的政治制度是什么？","entity的出生地采用什么制度治国？","什么政治制度被entity的出生地所采用？"]
["province", "region"]	["entity所在的省份所在区域是哪里？",""]
["subdivisionName", "中央銀行"]	["entity的中央银行是什么？","什么是entity的中央银行？"]
["deathPlace", "法律體系"]	["entity的死亡地点的法律体系是什么？","什么法律体系被entity的死亡地点使用？"]
["location", "曆法"]	["entity的历法是什么？","entity地区采用什么历法？"]
["publisher", "location"]	["entity的出版商位于哪里？entity的出版商的位置是什么？"]
["origin", "政治制度二"]	["entity的国家政权是什么结构？"]
["subdivisionName", "主要節日"]	["entity的主要节日是什么？","什么节日是entity的主要节日？"]
["workInstitution", "chancellor"]	["entity的工作机构的校长是谁？","谁是entity的工作机构的校长？"]
["subdivisionName", "leaderName"]	["entity的领导者是谁？","entity的市长的名字是什么？","谁是entity的市长？"]
["subdivisionName", "type"]	["entity的职业是什么？"]
["branch", "battles"]	["entity的一CLPM个分支参加了什么战争？","哪个战争中有entity的一CLPM个分支参战？"]
["starring", "spouse"]	["一CLPM个主演entity的演员的配偶是谁？"]
["country", "最長河流"]	["entity的最长河流叫什么名字？","哪条河是entity中最长的河流？"]
["state", "leaderName"]	["entity所属的州的领导者是谁？","entity所属的州的市长的名字是什么？","谁是entity所属的州的市长？"]
["deputy", "party"]	["entity的副手属于什么党派？","entity的副手加入了哪个党派？"]
["president", "party"]	["entity的总裁属于什么党派？","entity的总裁加入了哪个党派？"]
["placeOfDeath", "officiallang"]	["entity的死亡地点的官方语言是什么？"]
["predecessor", "successor"]	["entity的前身的后继是什么？"]
["birthPlace", "西"]	["entity的出生地西部的海洋是什么？","什么海位于entity的出生地西部？"]
["country", "国家政权"]	["entity的国家政权是什么？"]
["after", "awards"]	["entity获得奖项有什么？","entity被评选为什么奖？","什么奖项曾颁发给entity？"]
["country", "立國事件"]	["entity的立国事件是什么？","什么事件标志着entity成立？"]
["areaServed", "subdivisionName"]	["entity服务的区域属于哪个国家？","entity服务的区域位于哪个国家？"]
["employer", "president"]	["entity的校长是谁？","谁是entity的校长？"]
["city", "timezone"]	["entity所在的城市使用的时区是什么？","entity所在的城市按哪个时区记时？"]
["deathPlace", "north"]	["entity的死亡地点的北部是哪个城市？","哪个城市位于entity的死亡地点的北部？"]
["birthPlace", "type"]	["entity的出生地的职业是什么？"]
["location", "timezone"]	["entity使用的时区是什么？","entity按哪个时区记时？"]
["country", "政治制度二"]	["entity的国家政权是什么结构？"]
["address", "貨幣單位"]	["entity的地址的货币单位是什么？","entity的地址使用什么货币？","哪种货币在entity的地址流通？"]
["manufacturer", "location"]	["entity的制造商位于哪里？entity的制造商的位置是什么？"]
["president", "awards"]	["entity的总裁获得奖项有什么？","entity的总裁被评选为什么奖？","什么奖项曾颁发给entity的总裁？"]
["playedFor", "logo"]	["entity的logo是什么样子？","entity的标志的图片是什么？"]
["nationality", "國家結構形式"]	["entity的国籍的国家结构形式是什么？","entity的国籍是什么体制的国家？"]
["nationality", "立國事件"]	["entity的国籍的立国事件是什么？","什么事件标志着entity的国籍成立？"]
["subdivisionName", "最大城市名稱"]	["entity的最大的城市的名称是什么？","哪座城市是entity中最大的城市？"]
["placeOfBirth", "subdivisionType"]	["entity的出生地的划分种类是什么？"]
["subdivisionName", "timezone"]	["entity使用的时区是什么？","entity按哪个时区记时？"]
["placeOfBirth", "北"]	["entity的出生地的北部城市是什么？","什么城市位于entity的出生地北部？"]
["deathPlace", "house"]	["entity的死亡地点的下议院是什么？"]
["placeOfBirth", "立國事件"]	["entity的出生地的立国事件是什么？","什么事件标志着entity的出生地成立？"]
["deathPlace", "道路通行方向"]	["entity的死亡地点的道路通行方向是什么？","在entity的死亡地点人们倾向于靠什么方向通行？"]
["deathPlace", "國家代碼"]	["entity的死亡地点的国家代码是什么？"]
["states", "官方文字"]	["entity所在的州的官方文字是什么？","在entity所在的州人们用什么语言交流？","entity所在的州人的交流语言是什么？","entity所在的州人说什么语言？"]
["almaMater", "logo"]	["entity的母校的logo是什么样子？","entity的母校的标志的图片是什么？"]
["placeOfBirth", "governingBody"]	["entity的出生地的执政团体是谁？","entity的出生地的主管部门是什么？","哪个部门主管entity的出生地？"]
["placeOfBirth", "国家政权"]	["entity的出生地的国家政权是什么？"]
["shipBuilder", "governor"]	["entity的建设者的省长是谁？","谁是entity的建设者的总督？"]
["deathPlace", "leaderName"]	["entity的死亡地点的领导者是谁？","entity的死亡地点的市长的名字是什么？","谁是entity的死亡地点的市长？"]
["location", "中央政府所在地"]	["entity的中央政府所在地是哪里？"]
["location", "north"]	["entity的北部是哪个城市？","哪个城市位于entity的北部？"]
["location", "timezoneDst"]	["entity使用的时区是什么？","entity按哪个时区记时？"]
["birthPlace", "timezoneDst"]	["entity的出生地使用的时区是什么？","entity的出生地按哪个时区记时？"]
["headquarters", "西北"]	["entity的总部西南部的海洋是什么？","什么海位于entity的总部西南部？"]
["placeOfBirth", "timezoneDst"]	["entity的出生地使用的时区是什么？","entity的出生地按哪个时区记时？"]
["origin", "subdivisionName"]	["entity属于哪个国家？","entity位于哪个国家？"]
["associatedActs", "instrument"]	["entity的相关行为演奏的乐器是什么？","entity的相关行为表演什么乐器？"]
["writer", "職業"]	["entity的作家的职业是什么？","entity的作家是做什么的？"]
["associatedActs", "notableInstruments"]	["entity的相关行为的成名乐器是什么？","entity的相关行为以什么乐器著名？"]
["party", "predecessor"]	["entity所属的政党的前身是什么？"]
["headquarters", "中央銀行"]	["entity的总部的中央银行是什么？","什么是entity的总部的中央银行？"]
["place", "subdivisionType"]	["entity发生的地方的划分种类是什么？"]
["birthPlace", "法律體系"]	["entity的出生地的法律体系是什么？","什么法律体系被entity的出生地使用？"]
["birthPlace", "currency"]	["entity的出生地中使用的货币是什么？","什么货币在entity的出生地中被使用？","entity的出生地中流通的货币是什么？"]
["placeOfBirth", "premierparty"]	["entity的出生地的总理党是什么？","entity的出生地的首要党派是什么？哪个党派在entity的出生地中处于首要位置？"]
["placeOfDeath", "leaderName"]	["entity的死亡地点的领导者是谁？","entity的死亡地点的市长的名字是什么？","谁是entity的死亡地点的市长？"]
["nationality", "中央銀行"]	["entity的国籍的中央银行是什么？","什么是entity的国籍的中央银行？"]
["primeminister", "primeminister"]	["entity的总理的首相是谁？","谁是entity的总理的首相？"]
["birthPlace", "premierparty"]	["entity的出生地的总理党是什么？","entity的出生地的首要党派是什么？哪个党派在entity的出生地中处于首要位置？"]
["location", "國花"]	["entity的国花是什么？","哪种花是entity的国花？"]
["deathPlace", "國家憲法"]	["entity的死亡地点的国家宪法叫什么？","哪部法律是entity的死亡地点的国家宪法？"]
["operatingSystem", "supportedPlatforms"]	["entity的支撑平台是什么？","哪个平台支撑entity？"]
["influenced", "paradigm"]	["entity影响的人的范例是什么？","举出一个entity影响的人的范例？"]
["locationCountry", "最大行政區名稱"]	["entity所在的国家的最大行政区名称是什么？"]
["birthPlace", "governor"]	["entity的出生地的省长是谁？","谁是entity的出生地的总督？"]
["nationality", "主要節日"]	["entity的国籍的主要节日是什么？","什么节日是entity的国籍的主要节日？"]
["subdivisionName", "largestcity"]	["entity的最大的城市的名称是什么？","哪座城市是entity中最大的城市？"]
["origin", "timezone"]	["entity使用的时区是什么？","entity按哪个时区记时？"]
["placeOfDeath", "governmentType"]	["entity的死亡地点的市政管理组织模式是什么？","市政管理在entity的死亡地点是如何组织的？"]
["label", "genre"]	["制作entity的录音标签的演唱类型是什么?","制作entity的录音标签演唱什么类型的音乐？"]
["residence", "國家結構形式"]	["entity的住所的国家结构形式是什么？","entity的住所是什么体制的国家？"]
["publisher", "founder"]	["entity的出版商的创办者是谁？","谁创立了entity的出版商？","entity的出版商由谁建立？"]
["headquarters", "国家政权"]	["entity的总部的国家政权是什么？"]
["honorificSuffix", "higher"]	["entity的敬语后缀的上一个等级勋章是什么？","什么勋章位于entity的敬语后缀的上一个等级？","比entity的敬语后缀等级高一等的勋章是什么？"]
["state", "governor"]	["entity所属的州的省长是谁？","谁是entity所属的州的总督？"]
["origin", "最長河流"]	["entity的最长河流叫什么名字？","哪条河是entity中最长的河流？"]
["country", "法律體系"]	["entity的法律体系是什么？","什么法律体系被entity使用？"]
["shipCountry", "eventStart"]	["船舶entity所属的国家/地区是什么事件的开始时间?","什么事件开始于船舶entity所属的国家/地区？","哪个事件在船舶entity所属的国家/地区开始？"]
["partof", "commander"]	["entity的一部分的指挥官是谁？","entity的一部分受谁的指挥？","谁指挥entity的一部分？"]
["city", "timezoneDst"]	["entity所在的城市使用的时区是什么？","entity所在的城市按哪个时区记时？"]
["birthPlace", "capital"]	["entity的出生地的省会是哪里？","entity的出生地的省会叫什么？","哪里是entity的出生地的省会？"]
["deathPlace", "西北"]	["entity的死亡地点西南部的海洋是什么？","什么海位于entity的死亡地点西南部？"]
["extra", "currentMembers"]	["entity的的现有成员是谁？","谁现在在entity的中？"]
["birthPlace", "event"]	["entity的出生地期间发生的事件有什么？","什么事件在entity的出生地期间发生？"]
["placeofburial", "官方語言"]	["entity的官方语言是什么？","在entity人们用什么语言交流？","entity人的交流语言是什么？","entity人说什么语言？"]
["shipOperator", "aircraftAttack"]	["entity的船舶经营者的攻击机是什么？"]
["shipBuilder", "leaderName"]	["entity的建设者的领导者是谁？","entity的建设者的市长的名字是什么？","谁是entity的建设者的市长？"]
["producer", "genre"]	["entity的生产者的演唱类型是什么?","entity的生产者演唱什么类型的音乐？"]
["workInstitution", "affiliations"]	["entity的工作机构的附属机构是什么？"]
["deathPlace", "官方語言"]	["entity的死亡地点的官方语言是什么？","在entity的死亡地点人们用什么语言交流？","entity的死亡地点人的交流语言是什么？","entity的死亡地点人说什么语言？"]
["manufacturer", "products"]	["entity的制造商的产品都有什么？"]
["deathPlace", "最長河流"]	["entity的死亡地点的最长河流叫什么名字？","哪条河是entity的死亡地点中最长的河流？"]
["origin", "senators"]	["entity的参议员是谁？"]
["residence", "subdivisionName"]	["entity的住所属于哪个国家？","entity的住所位于哪个国家？"]
["nationalteam", "location"]	["entity的国家队位于哪里？entity的国家队的位置是什么？"]
["city", "postalCodeType"]	["entity所在的城市的邮政编码是什么？"]
["president", "predecessor"]	["entity的总裁的前身是什么？"]
["combatant", "religion"]	["entity的战士的宗教信仰是什么？","entity的战士信仰什么教？"]
["platforms", "kernelType"]	["entity所处的平台的内核类型是什么？"]
["platforms", "onlineService"]	["entity所处的平台的线上服务由什么提供？"]
["primaryUser", "aircraftAttack"]	["entity的主要用户的攻击机是什么？"]
["title", "gm"]	["entity的标题的总经理是谁？","谁是entity的标题的总经理？","entity的标题的总经理叫什么名字？"]
["location", "国家政权"]	["entity的国家政权是什么？"]
["location", "東南"]	["entity东南部的海洋是什么？","什么海位于entity东南部？"]
["origin", "國家結構形式"]	["entity的国家结构形式是什么？","entity是什么体制的国家？"]
["channel", "擁有者"]	["entity所属的电视频道的拥有着是谁？","谁拥有entity所属的电视频道?","entity所属的电视频道被谁所拥有?"]
["father", "house"]	["entity的父亲的下议院是什么？"]
["producer", "associatedActs"]	["与entity的生产者有关系的演员是谁？"]
["formerAffiliations", "擁有者"]	["entity的前隶属关系的拥有着是谁？","谁拥有entity的前隶属关系?","entity的前隶属关系被谁所拥有?"]
["placeOfBirth", "民族"]	["entity的出生地的民族有哪些？","entity的出生地包含哪些民族？"]
["label", "keyPeople"]	["制作entity的录音标签的最重要的职务是什么？","制作entity的录音标签中最高职位是什么？"]
["nationality", "國家首都名稱"]	["entity的国籍的首都是什么？","哪里是entity的国籍的首都？"]
["distributor", "industry"]	["entity的经销商属于什么产业？"]
["origin", "timezoneDst"]	["entity使用的时区是什么？","entity按哪个时区记时？"]
["placeOfBirth", "立國日期"]	["entity的出生地的建国日期是什么？"]
["residence", "leaderName"]	["entity的住所的领导者是谁？","entity的住所的市长的名字是什么？","谁是entity的住所的市长？"]
["extra", "genre"]	["entity的的演唱类型是什么?","entity的演唱什么类型的音乐？"]
["placeOfBirth", "最大行政區名稱"]	["entity的出生地的最大行政区名称是什么？"]
["operator", "battles"]	["entity的运营商参加了什么战争？","哪个战争中有entity的运营商参战？"]
["founded", "west"]	["entity的西部城市是什么？","哪个城市位于entity西部？"]
["founded", "官方語言"]	["entity的官方语言是什么？","在entity人们用什么语言交流？","entity人的交流语言是什么？","entity人说什么语言？"]
["city", "國家政權"]	["entity所在的城市的国家政权是什么结构？"]
["placeOfBirth", "type"]	["entity的出生地的职业是什么？"]
["programmingLanguage", "logo"]	["entity编写的编程语言的logo是什么样子？","entity编写的编程语言的标志的图片是什么？"]
["subsid", "industry"]	["是entity补贴属于什么产业？"]
["subdivisionName", "最長河流"]	["entity的最长河流叫什么名字？","哪条河是entity中最长的河流？"]
["distributor", "products"]	["entity的经销商的产品都有什么？"]
["origin", "官方語言"]	["entity的官方语言是什么？","在entity人们用什么语言交流？","entity人的交流语言是什么？","entity人说什么语言？"]
["origin", "subdivisionType"]	["entity的划分种类是什么？"]
["origin", "governingBody"]	["entity的执政团体是谁？","entity的主管部门是什么？","哪个部门主管entity？"]
["deathPlace", "立國日期"]	["entity的死亡地点的建国日期是什么？"]
["deathPlace", "國花"]	["entity的死亡地点的国花是什么？","哪种花是entity的死亡地点的国花？"]
["birthPlace", "貨幣代碼"]	["entity的出生地的货币代码是什么?",""]
["placeOfBirth", "leaderName"]	["entity的出生地的领导者是谁？","entity的出生地的市长的名字是什么？","谁是entity的出生地的市长？"]
["binomialAuthority", "knownFor"]	["entity的二项式名称的作者因何著名？","entity的二项式名称的作者的成名作是什么？","什么使得entity的二项式名称的作者出名？"]
["location", "民族"]	["entity的民族有哪些？","entity包含哪些民族？"]
["tenants", "stadium"]	["entity的居住地的体育馆是什么？","哪里是entity的居住地的体育馆？"]
["site", "premierparty"]	["entity的总理党是什么？","entity的首要党派是什么？哪个党派在entity中处于首要位置？"]
["tenants", "league"]	["entity的居住地参与的联赛叫什么名字？","entity的居住地在哪个联赛中参加比赛？"]
["state", "postalcodeprefix"]	["entity所属的州的邮政编码前缀是什么？"]
["almaMater", "conference"]	["entity的母校属于哪个联盟？","entity的母校在哪个联盟中？"]
["tenants", "location"]	["entity的居住地位于哪里？entity的居住地的位置是什么？"]
["tenants", "name"]	["entity的居住地的繁体形式是什么？","entity的居住地的繁体怎么写？"]
["after", "predecessor"]	["entity的前身是什么？"]
["platforms", "successor"]	["entity所处的平台的后继是什么？"]
["area", "官方語言"]	["entity所在的区域的官方语言是什么？","在entity所在的区域人们用什么语言交流？","entity所在的区域人的交流语言是什么？","entity所在的区域人说什么语言？"]
["birthPlace", "最高點"]	["entity的出生地的最高点在哪里？","哪里是entity的出生地最高的地方？"]
["influences", "awards"]	["entity的影响获得奖项有什么？","entity的影响被评选为什么奖？","什么奖项曾颁发给entity的影响？"]
["placeOfBirth", "officiallang"]	["entity的出生地的官方语言是什么？"]
["country", "貨幣單位"]	["entity的货币单位是什么？","entity使用什么货币？","哪种货币在entity流通？"]
["placeOfBirth", "postalcodeprefix"]	["entity的出生地的邮政编码前缀是什么？"]
["shipBuilder", "道路通行方向"]	["entity的建设者的道路通行方向是什么？","在entity的建设者人们倾向于靠什么方向通行？"]
["shipBuilder", "最大湖泊"]	["entity的建设者的最大湖泊是什么湖？","哪个湖是entity的建设者中最大的湖泊？"]
["residence", "西北"]	["entity的住所西南部的海洋是什么？","什么海位于entity的住所西南部？"]
["successor", "predecessor"]	["entity的接班人的前身是什么？"]
["location", "北"]	["entity的北部城市是什么？","什么城市位于entity北部？"]
["origin", "官方文字"]	["entity的官方文字是什么？","在entity人们用什么语言交流？","entity人的交流语言是什么？","entity人说什么语言？"]
["region", "國家首都名稱"]	["entity所属的地区的首都是什么？","哪里是entity所属的地区的首都？"]
["placeOfBirth", "最長河流"]	["entity的出生地的最长河流叫什么名字？","哪条河是entity的出生地中最长的河流？"]
["clubs", "shirtsupplier"]	["entity所在的俱乐部的球衣供应商是谁？","谁为entity所在的俱乐部提供球衣？"]
["name", "clubs"]	["entity的名字效力的球队是什么？","entity的名字隶属于哪个球队？"]
["name", "nationalteam"]	["entity的名字隶属于哪个国家队？","entity的名字为哪个国家队效力？"]
["club", "ground"]	["entity所在的俱乐部的主场在哪里？"]
["club", "name"]	["entity所在的俱乐部的繁体形式是什么？","entity所在的俱乐部的繁体怎么写？"]
["billed", "subdivisionName"]	["entity属于哪个国家？","entity位于哪个国家？"]
["finalsChamp", "captain"]	["entity的最终冠军的首都是什么？","哪里是entity的最终冠军的首都？","entity的最终冠军的首都位于哪里？"]
["birthPlace", "south"]	["entity的出生地的南部是哪个城市？","哪个城市位于entity的出生地的南部？"]
["birthPlace", "west"]	["entity的出生地的西部城市是什么？","哪个城市位于entity的出生地西部？"]
["birthPlace", "國家政權"]	["entity的出生地的国家政权是什么结构？"]
["origin", "道路通行方向"]	["entity的道路通行方向是什么？","在entity人们倾向于靠什么方向通行？"]
["location", "type"]	["entity的职业是什么？"]
["education", "logo"]	["entity参加的大学的logo是什么样子？","entity参加的大学的标志的图片是什么？"]
["locationCountry", "國家政權"]	["entity所在的国家的国家政权是什么结构？"]
["residence", "legislature"]	["entity的住所的立法机构是什么？"]
["region", "leaderName"]	["entity所属的地区的领导者是谁？","entity所属的地区的市长的名字是什么？","谁是entity所属的地区的市长？"]
["areaServed", "國家憲法"]	["entity服务的区域的国家宪法叫什么？","哪部法律是entity服务的区域的国家宪法？"]
["location", "postalCodeType"]	["entity的邮政编码是什么？"]
["origin", "主要節日"]	["entity的主要节日是什么？","什么节日是entity的主要节日？"]
["residence", "governmentType"]	["entity的住所的市政管理组织模式是什么？","市政管理在entity的住所是如何组织的？"]
["nationality", "國家政權"]	["entity的国籍的国家政权是什么结构？"]
["state", "senators"]	["entity所属的州的参议员是谁？"]
["birthPlace", "國際域名縮寫"]	["entity的出生地的国际域名缩写是什么？","entity的出生地的可以缩写成什么？","什么可以用作entity的出生地的缩写？"]
["format", "icon"]	["entity的格式的图标是什么？","entity的格式图标长什么样？"]
["subdivisionName", "lieutenantGovernor"]	["entity的副州长是谁？","谁是entity的副州长？"]
["programmingLanguage", "influencedBy"]	["entity编写的编程语言受到什么的影响？","什么对entity编写的编程语言产生了影响？"]
["birthPlace", "largestcity"]	["entity的出生地的最大的城市的名称是什么？","哪座城市是entity的出生地中最大的城市？"]
["shipBuilder", "postalCodeType"]	["entity的建设者的邮政编码是什么？"]
["assembly", "timezone"]	["entity的装配使用的时区是什么？","entity的装配按哪个时区记时？"]
["country", "最大湖泊"]	["entity的最大湖泊是什么湖？","哪个湖是entity中最大的湖泊？"]
["origin", "leaderName"]	["entity的领导者是谁？","entity的市长的名字是什么？","谁是entity的市长？"]
["nominee", "successor"]	["entity的候选人的后继是什么？"]
["country", "西"]	["entity西部的海洋是什么？","什么海位于entity西部？"]
["currentclub", "city"]	["entity的城市有哪个？","举出一个entity中的城市？"]
["director", "before"]	["entity的导演的上一位是什么？"]
["areaServed", "中央銀行"]	["entity服务的区域的中央银行是什么？","什么是entity服务的区域的中央银行？"]
["areasServed", "國家結構形式"]	["entity服务的区域的国家结构形式是什么？","entity服务的区域是什么体制的国家？"]
["operatingSystem", "license"]	["entity的许可证是什么？","什么许可证被entity使用？"]
["nationalteam", "topScorer"]	["entity的国家队的最佳射手是谁？","谁是entity的国家队的最佳射手？"]
["subdivisionName", "曆法"]	["entity的历法是什么？","entity地区采用什么历法？"]
["birthPlace", "commonLanguages"]	["entity的出生地的普遍使用语言是什么？"]
["clubs", "shirtsponsors"]	["entity所在的俱乐部的球衣供应商是谁？","谁为entity所在的俱乐部提供球衣？"]
["subdivisionName", "subdivisionName"]	["entity属于哪个国家？","entity位于哪个国家？"]
["subdivisionName", "subdivisionType"]	["entity的划分种类是什么？"]
["city", "leaderName"]	["entity所在的城市的领导者是谁？","entity所在的城市的市长的名字是什么？","谁是entity所在的城市的市长？"]
["origin", "國家政權"]	["entity的国家政权是什么结构？"]
["birthPlace", "eventStart"]	["entity的出生地是什么事件的开始时间?","什么事件开始于entity的出生地？","哪个事件在entity的出生地开始？"]
["placeOfBirth", "commonLanguages"]	["entity的出生地的普遍使用语言是什么？"]
["placeOfDeath", "西"]	["entity的死亡地点西部的海洋是什么？","什么海位于entity的死亡地点西部？"]
["birthPlace", "location"]	["entity的出生地位于哪里？entity的出生地的位置是什么？"]
["label", "location"]	["制作entity的录音标签位于哪里？制作entity的录音标签的位置是什么？"]
["platforms", "license"]	["entity所处的平台的许可证是什么？","什么许可证被entity所处的平台使用？"]
["areaServed", "曆法"]	["entity服务的区域的历法是什么？","entity服务的区域地区采用什么历法？"]
["placeOfBirth", "populationRank"]	["entity的出生地的人口排名是多少？","entity的出生地的人口排在多少名？"]
["deathPlace", "中央銀行"]	["entity的死亡地点的中央银行是什么？","什么是entity的死亡地点的中央银行？"]
["placeOfDeath", "政治制度三"]	["entity的死亡地点的政治制度是什么？","entity的死亡地点采用什么制度治国？","什么政治制度被entity的死亡地点所采用？"]
["stadium", "subdivisionName"]	["entity发生的体育场属于哪个国家？","entity发生的体育场位于哪个国家？"]
["stadium", "subdivisionType"]	["entity发生的体育场的划分种类是什么？"]
["placeOfDeath", "立國事件"]	["entity的死亡地点的立国事件是什么？","什么事件标志着entity的死亡地点成立？"]
["almaMater", "state"]	["entity的母校在哪个州？","entity的母校位于哪个州？"]
["primeminister", "before"]	["entity的总理的上一位是什么？"]
["deathPlace", "largestcity"]	["entity的死亡地点的最大的城市的名称是什么？","哪座城市是entity的死亡地点中最大的城市？"]
["team", "city"]	["entity所在的团队的城市有哪个？","举出一个entity所在的团队中的城市？"]
["team", "ceo"]	["entity所在的团队的Centity所在的团队O是谁？","entity所在的团队的首席执行官是谁？","谁是entity所在的团队的Centity所在的团队O?"]
["shipBuilder", "namedFor"]	["entity的建设者以什么语言命名?","什么语言命名了entity的建设者？"]
["workInstitution", "city"]	["entity的工作机构的城市有哪个？","举出一个entity的工作机构中的城市？"]
["playingTeam", "stadium"]	["entity所扮演的团队的体育馆是什么？","哪里是entity所扮演的团队的体育馆？"]
["studio", "keyPeople"]	["制作entity的工作室的最重要的职务是什么？","制作entity的工作室中最高职位是什么？"]
["locale", "subdivisionName"]	["entity属于哪个国家？","entity位于哪个国家？"]
["state", "officiallang"]	["entity所属的州的官方语言是什么？"]
["region", "東"]	["entity所属的地区东部的海洋是什么？","什么海位于entity所属的地区东部？"]
["commonLanguages", "fam"]	["entity起源于什么语言？","entity由什么语言演变而来？"]
["associatedActs", "placeOfBirth"]	["entity的相关行为的出生地是哪里？","entity的相关行为在那里出生？"]
["publisher", "keyPeople"]	["entity的出版商的最重要的职务是什么？","entity的出版商中最高职位是什么？"]
["placeOfBirth", "國家外文語言"]	["entity的出生地的国家语言是什么？","entity的出生地使用什么语言？","在entity的出生地中人们用什么语言交流?"]
["deathPlace", "capital"]	["entity的死亡地点的省会是哪里？","entity的死亡地点的省会叫什么？","哪里是entity的死亡地点的省会？"]
["location", "viceroy"]	["entity的总督是谁？","谁是entity的总督？","entity的最高行政长官是谁？","谁是entity的最高行政长官？"]
["youthclubs", "nickname"]	["entity的绰号叫什么？","entity又被称为什么？","entity的另外的名字是什么？"]
["state", "largestmetro"]	["entity所属的州的地铁在哪个区域？"]
["youthclubs", "shirtsponsors"]	["entity的球衣供应商是谁？","谁为entity提供球衣？"]
["party", "leader1Name"]	["entity所属的政党的领导者叫什么？","entity所属的政党领导人的名字是什么？","谁领导entity所属的政党？"]
["placeOfBirth", "governmentType"]	["entity的出生地的市政管理组织模式是什么？","市政管理在entity的出生地是如何组织的？"]
["after", "birthPlace"]	["entity的出生地是哪里？","entity在哪里出生？"]
["birthPlace", "postalCodeType"]	["entity的出生地的邮政编码是什么？"]
["location", "capital"]	["entity的省会是哪里？","entity的省会叫什么？","哪里是entity的省会？"]
["managerclubs", "stadium"]	["entity管理的俱乐部的体育馆是什么？","哪里是entity管理的俱乐部的体育馆？"]
["classis", "subdivisionRanks"]	["entity的分类的分类等级是什么？","entity的分类在分类中处于什么等级？"]
["nationalOrigin", "西"]	["entity西部的海洋是什么？","什么海位于entity西部？"]
["placeOfDeath", "postalCodeType"]	["entity的死亡地点的邮政编码是什么？"]
["format", "fusiongenres"]	["entity的格式的融合形式是什么？","融合过的entity的格式形式是什么？"]
["managerclubs", "league"]	["entity管理的俱乐部参与的联赛叫什么名字？","entity管理的俱乐部在哪个联赛中参加比赛？"]
["spouse", "after"]	["entity的配偶的下一位是什么？"]
["birthPlace", "governmentType"]	["entity的出生地的市政管理组织模式是什么？","市政管理在entity的出生地是如何组织的？"]
["primaryUser", "battles"]	["entity的主要用户参加了什么战争？","哪个战争中有entity的主要用户参战？"]
["broadcastArea", "政治制度二"]	["entityITY的国家政权是什么结构？"]
["deathPlace", "國家結構形式"]	["entity的死亡地点的国家结构形式是什么？","entity的死亡地点是什么体制的国家？"]
["continentalcup", "stadium"]	["是大陆杯entity的体育馆是什么？","哪里是是大陆杯entity的体育馆？"]
["location", "最高點"]	["entity的最高点在哪里？","哪里是entity最高的地方？"]
["successor", "after"]	["entity的接班人的下一位是什么？"]
["hostCity", "國家憲法"]	["entity的主办城市的国家宪法叫什么？","哪部法律是entity的主办城市的国家宪法？"]
["hostCity", "立國事件"]	["entity的主办城市的立国事件是什么？","什么事件标志着entity的主办城市成立？"]
["label", "industry"]	["制作entity的录音标签属于什么产业？"]
["monarch", "子女"]	["entity的君主的子女是谁？","谁是entity的君主的子女？"]
["president", "after"]	["entity的总裁的下一位是什么？"]
["mostSuccessfulClub", "name"]	["A最成功的entity俱乐部的繁体形式是什么？","A最成功的entity俱乐部的繁体怎么写？"]
["birthPlace", "lowestpoint"]	["entity的出生地的最低点在哪里？","哪里是entity的出生地的最低点？","entity的出生地海拔最低的地方是哪里？"]
["music", "genre"]	["制造entity的人的演唱类型是什么?","制造entity的人演唱什么类型的音乐？"]
["headquarters", "民族"]	["entity的总部的民族有哪些？","entity的总部包含哪些民族？"]
["regionServed", "timezone"]	["entity服务的地区使用的时区是什么？","entity服务的地区按哪个时区记时？"]
["regionServed", "國家結構形式"]	["entity服务的地区的国家结构形式是什么？","entity服务的地区是什么体制的国家？"]
["primeminister", "predecessor"]	["entity的总理的前身是什么？"]
["placeOfDeath", "官方語言"]	["entity的死亡地点的官方语言是什么？","在entity的死亡地点人们用什么语言交流？","entity的死亡地点人的交流语言是什么？","entity的死亡地点人说什么语言？"]
["origin", "governmentType"]	["entity的市政管理组织模式是什么？","市政管理在entity是如何组织的？"]
["origin", "貨幣代碼"]	["entity的货币代码是什么?",""]
["basinCountries", "立國事件"]	["entity盆地的立国事件是什么？","什么事件标志着entity盆地成立？"]
["locale", "governmentType"]	["entity的市政管理组织模式是什么？","市政管理在entity是如何组织的？"]
["west", "subdivisionName"]	["entityITY属于哪个国家？","entityITY位于哪个国家？"]
["moreUsers", "aircraftTrainer"]	["entity的用户的飞行练习器是什么？","哪些飞行练习器被entity的用户使用？"]
["langs", "states"]	["使用entity说的语言的地区有哪些？","哪里使用entity说的语言语言？"]
["residence", "貨幣單位"]	["entity的住所的货币单位是什么？","entity的住所使用什么货币？","哪种货币在entity的住所流通？"]
["officiallyOpenedBy", "as"]	["开了entity是谁？","开了entity的职务是什么？","开了entity的身份是什么？"]
["deathPlace", "主要節日"]	["entity的死亡地点的主要节日是什么？","什么节日是entity的死亡地点的主要节日？"]
["producer", "occupation"]	["entity的生产者的职业是什么？"]
["birthPlace", "最長河流"]	["entity的出生地的最长河流叫什么名字？","哪条河是entity的出生地中最长的河流？"]
["currentclub", "name"]	["entity的繁体形式是什么？","entity的繁体怎么写？"]
["deathPlace", "postalCodeType"]	["entity的死亡地点的邮政编码是什么？"]
["episodeList", "directedby"]	["entity所在的剧集列表的导演是谁？","entity所在的剧集列表是被谁执导？","谁导演的entity所在的剧集列表？","entity所在的剧集列表导演的名字是什么？"]
["almaMater", "city"]	["entity的母校的城市有哪个？","举出一个entity的母校中的城市？"]
["locationCity", "subdivisionType"]	["entity所在的城市的划分种类是什么？"]
["location", "最大行政區名稱"]	["entity的最大行政区名称是什么？"]
["nationalteam", "captain"]	["entity的国家队的首都是什么？","哪里是entity的国家队的首都？","entity的国家队的首都位于哪里？"]
["writer", "notableInstruments"]	["entity的作家的成名乐器是什么？","entity的作家以什么乐器著名？"]
["nationality", "東"]	["entity的国籍东部的海洋是什么？","什么海位于entity的国籍东部？"]
["areaServed", "governor"]	["entity服务的区域的省长是谁？","谁是entity服务的区域的总督？"]
["birthPlace", "region"]	["entity的出生地所在区域是哪里？",""]
["birthPlace", "貨幣單位"]	["entity的出生地的货币单位是什么？","entity的出生地使用什么货币？","哪种货币在entity的出生地流通？"]
["draftTeam", "division"]	["entity的选秀团队属于哪个赛区？","entity的选秀团队在哪个区域比赛？"]
["placeOfBirth", "era"]	["entity的出生地时代发生了什么战争？","什么战争发生在entity的出生地时代？"]
["employer", "founder"]	["entity的创办者是谁？","谁创立了entity？","entity由谁建立？"]
["platforms", "ui"]	["entity所处的平台的ui是什么？"]
["title", "location"]	["entity的标题位于哪里？entity的标题的位置是什么？"]
["state", "type"]	["entity所属的州的职业是什么？"]
["platforms", "developer"]	["entity所处的平台的创立者是谁？","是谁成立了entity所处的平台？","entity所处的平台是被谁建立的？"]
["platforms", "predecessor"]	["entity所处的平台的前身是什么？"]
["origin", "最大城市名稱"]	["entity的最大的城市的名称是什么？","哪座城市是entity中最大的城市？"]
["placeOfDeath", "event"]	["entity的死亡地点期间发生的事件有什么？","什么事件在entity的死亡地点期间发生？"]
["teaOrigin", "政治体制"]	["茶叶entity的政治体制是什么？","茶叶entity采用什么政治体制？"]
["workplaces", "battles"]	["entity的工作地点参加了什么战争？","哪个战争中有entity的工作地点参战？"]
["workplaces", "identificationSymbol"]	["entity的工作地点的标志符号是多少？"]
["country", "officialLanguages"]	["entity的官方语言是什么？","在entity人们用什么语言交流？","entity人的交流语言是什么？","entity人说什么语言？"]
["before", "after"]	["entity的下一位是什么？"]
["artist", "notableInstruments"]	["entity的艺术家的成名乐器是什么？","entity的艺术家以什么乐器著名？"]
["province", "officiallang"]	["entity所在的省份的官方语言是什么？"]
["assembly", "主要節日"]	["entity的装配的主要节日是什么？","什么节日是entity的装配的主要节日？"]
["regionServed", "postalcodeprefix"]	["entity服务的地区的邮政编码前缀是什么？"]
["regionServed", "legislature"]	["entity服务的地区的立法机构是什么？"]
["distributor", "type"]	["entity的经销商的职业是什么？"]
["developer", "keyPeople"]	["entity的开发者的最重要的职务是什么？","entity的开发者中最高职位是什么？"]
["draftTeam", "city"]	["entity的选秀团队的城市有哪个？","举出一个entity的选秀团队中的城市？"]
["subdivisionName", "立國事件"]	["entity的立国事件是什么？","什么事件标志着entity成立？"]
["finalteam", "before"]	["entity所在的最终团队的上一位是什么？"]
["publisher", "services"]	["entity的出版商提供的服务是什么？","entity的出版商可以提供什么服务？","entity的出版商是做什么的？","可以从entity的出版商获取什么服务？"]
["placeOfBirth", "主要宗教"]	["entity的出生地的主要宗教是什么？","什么宗教在entity的出生地属于主流？"]
["subdivisionName", "language"]	["entity的交流语言是什么？","entity使用什么语言交流？","什么语言被entity所使用？"]
["placeOfDeath", "type"]	["entity的死亡地点的职业是什么？"]
["managerclubs", "city"]	["entity管理的俱乐部的城市有哪个？","举出一个entity管理的俱乐部中的城市？"]
["citizenship", "官方文字"]	["entity的公民身份的官方文字是什么？","在entity的公民身份人们用什么语言交流？","entity的公民身份人的交流语言是什么？","entity的公民身份人说什么语言？"]
["citizenship", "曆法"]	["entity的公民身份的历法是什么？","entity的公民身份地区采用什么历法？"]
["citizenship", "立國日期"]	["entity的公民身份的建国日期是什么？"]
["placeOfDeath", "國家政權"]	["entity的死亡地点的国家政权是什么结构？"]
["managerclubs", "captain"]	["entity管理的俱乐部的首都是什么？","哪里是entity管理的俱乐部的首都？","entity管理的俱乐部的首都位于哪里？"]
["candidate", "successor"]	["entity的候选人的后继是什么？"]
["locationCity", "legislature"]	["entity所在的城市的立法机构是什么？"]
["author", "influenced"]	["entity的作者受影响于什么？","entity的作者受到什么的影响？"]
["designer", "commander"]	["entity的设计师的指挥官是谁？","entity的设计师受谁的指挥？","谁指挥entity的设计师？"]
["clubs", "manager"]	["entity所在的俱乐部的经理是谁？","谁是entity所在的俱乐部的经理？","谁经营管理entity所在的俱乐部？"]
["states", "官方語言"]	["entity所在的州的官方语言是什么？","在entity所在的州人们用什么语言交流？","entity所在的州人的交流语言是什么？","entity所在的州人说什么语言？"]
["owner", "nickname"]	["entity的所有者的绰号叫什么？","entity的所有者又被称为什么？","entity的所有者的另外的名字是什么？"]
["predecessor", "office"]	["entity的前身的官职是什么？","entity的前身的职位是什么？"]
["deathPlace", "民族"]	["entity的死亡地点的民族有哪些？","entity的死亡地点包含哪些民族？"]
["primeminister", "successor"]	["entity的总理的后继是什么？"]
["predecessor", "awards"]	["entity的前身获得奖项有什么？","entity的前身被评选为什么奖？","什么奖项曾颁发给entity的前身？"]
["placeOfDeath", "國家首都名稱"]	["entity的死亡地点的首都是什么？","哪里是entity的死亡地点的首都？"]
["shortDescription", "國家政權"]	["entity的简短描述的国家政权是什么结构？"]
["league", "ceo"]	["entity的联盟的Centity的联盟O是谁？","entity的联盟的首席执行官是谁？","谁是entity的联盟的Centity的联盟O?"]
["birthPlace", "西南"]	["entity的出生地西南部的海洋是什么？","什么海位于entity的出生地西南部？"]
["deathPlace", "官方文字"]	["entity的死亡地点的官方文字是什么？","在entity的死亡地点人们用什么语言交流？","entity的死亡地点人的交流语言是什么？","entity的死亡地点人说什么语言？"]
["billed", "subdivisionType"]	["entity的划分种类是什么？"]
["placeOfDeath", "中央銀行"]	["entity的死亡地点的中央银行是什么？","什么是entity的死亡地点的中央银行？"]
["team", "generalManager"]	["entity所在的团队的总经理是谁？","谁是entity所在的团队的总经理？","entity所在的团队的总经理叫什么名字？"]
["distributor", "keyPeople"]	["entity的经销商的最重要的职务是什么？","entity的经销商中最高职位是什么？"]
["familia", "subdivisionRanks"]	["entity的家庭的分类等级是什么？","entity的家庭在分类中处于什么等级？"]
["team", "conference"]	["entity所在的团队属于哪个联盟？","entity所在的团队在哪个联盟中？"]
["nationality", "政治制度二"]	["entity的国籍的国家政权是什么结构？"]
["nationality", "西"]	["entity的国籍西部的海洋是什么？","什么海位于entity的国籍西部？"]
["placeOfDeath", "populationRank"]	["entity的死亡地点的人口排名是多少？","entity的死亡地点的人口排在多少名？"]
["creator", "almaMater"]	["entity的创造者的母校是哪？","哪个学校是entity的创造者的母校？"]
["influenced", "influenced"]	["entity影响的人受影响于什么？","entity影响的人受到什么的影响？"]
["place", "曆法"]	["entity发生的地方的历法是什么？","entity发生的地方地区采用什么历法？"]
["genusAuthority", "fields"]	["entity属名的创造者的研究领域是什么？","entity属名的创造者致力于哪个领域的研究？"]
["birthPlace", "religion"]	["entity的出生地的宗教信仰是什么？","entity的出生地信仰什么教？"]
["album", "genre"]	["entity的专辑的演唱类型是什么?","entity的专辑演唱什么类型的音乐？"]
["clubs", "city"]	["entity所在的俱乐部的城市有哪个？","举出一个entity所在的俱乐部中的城市？"]
["country", "國花"]	["entity的国花是什么？","哪种花是entity的国花？"]
["stadium", "after"]	["entity发生的体育场的下一位是什么？"]
["education", "president"]	["entity参加的大学的校长是谁？","谁是entity参加的大学的校长？"]
["developer", "products"]	["entity的开发者的产品都有什么？"]
["shortDescription", "主要節日"]	["entity的简短描述的主要节日是什么？","什么节日是entity的简短描述的主要节日？"]
["location", "國家憲法"]	["entity的国家宪法叫什么？","哪部法律是entity的国家宪法？"]
["team", "league"]	["entity所在的团队参与的联赛叫什么名字？","entity所在的团队在哪个联赛中参加比赛？"]
["locale", "南"]	["entity南部水域是什么？","哪个水域位于entity南部？"]
["birthPlace", "最大行政區名稱"]	["entity的出生地的最大行政区名称是什么？"]
["team", "division"]	["entity所在的团队属于哪个赛区？","entity所在的团队在哪个区域比赛？"]
["regionServed", "曆法"]	["entity服务的地区的历法是什么？","entity服务的地区地区采用什么历法？"]
["signedpresident", "party"]	["entity签署的总统属于什么党派？","entity签署的总统加入了哪个党派？"]
["placeOfDeath", "西南"]	["entity的死亡地点西南部的海洋是什么？","什么海位于entity的死亡地点西南部？"]
["almaMater", "president"]	["entity的母校的校长是谁？","谁是entity的母校的校长？"]
["origin", "國家首都名稱"]	["entity的首都是什么？","哪里是entity的首都？"]
["origin", "animal"]	["entity有什么动物？","什么动物生活在entity？"]
["based", "leaderName"]	["entity的领导者是谁？","entity的市长的名字是什么？","谁是entity的市长？"]
["based", "subdivisionName"]	["entity属于哪个国家？","entity位于哪个国家？"]
["primaryUser", "aircraftRecon"]	["entity的主要用户的侦察机有什么？","哪些是entity的主要用户的侦察机？"]
["college", "city"]	["entity的城市有哪个？","举出一个entity中的城市？"]
["placeOfBirth", "政治体制"]	["entity的出生地的政治体制是什么？","entity的出生地采用什么政治体制？"]
["state", "lieutenantGovernor"]	["entity所属的州的副州长是谁？","谁是entity所属的州的副州长？"]
["deathPlace", "type"]	["entity的死亡地点的职业是什么？"]
["artist", "職業"]	["entity的艺术家的职业是什么？","entity的艺术家是做什么的？"]
["college", "athletics"]	["entity中的运动有什么？","什么比赛有entity的参加？"]
["origin", "國家憲法"]	["entity的国家宪法叫什么？","哪部法律是entity的国家宪法？"]
["city", "capital"]	["entity所在的城市的省会是哪里？","entity所在的城市的省会叫什么？","哪里是entity所在的城市的省会？"]
